path	sentence
/root/repos/dli_del/data/wav_split_gold/654.wav	yesya arwămda awdamda».
/root/repos/dli_del/data/wav_split_gold/693.wav	"Tăryemhsirŋā anih,"
/root/repos/dli_del/data/wav_split_gold/756.wav	nyeriq.»
/root/repos/dli_del/data/wav_split_gold/1521.wav	Miniko laănăkoda ŋanih nyanănda ai. 
/root/repos/dli_del/data/wav_split_gold/68.wav	Ti raciyaăna maq. 
/root/repos/dli_del/data/wav_split_gold/1444.wav	ŋămgǣǣrtărimboy. 
/root/repos/dli_del/data/wav_split_gold/342.wav	  Siirtya maqniwh: 
/root/repos/dli_del/data/wav_split_gold/803.wav	tyaănyaŋi nisyǎ mih tiki muŋgoh pyayq tiki syudbyako lăbtǣyh myunya ŋămgǣǣw yar sonyoq.
/root/repos/dli_del/data/wav_split_gold/352.wav	 maănda maănda nyana padda tari(tǣri) labtorŋa.
/root/repos/dli_del/data/wav_split_gold/1420.wav	"«ălcoqlǣr ti, "
/root/repos/dli_del/data/wav_split_gold/405.wav	tyuku manʹ ancyerh ilyedmh tyedah. 
/root/repos/dli_del/data/wav_split_gold/860.wav	«Nyuml ŋǣdakǣ̄».
/root/repos/dli_del/data/wav_split_gold/1097.wav	"tyeda ŋumdămih niŋgăanih,"
/root/repos/dli_del/data/wav_split_gold/738.wav	nyudya ăbimh panătă̌ta ŋudah wǣta nyǎqămaqda.
/root/repos/dli_del/data/wav_split_gold/1237.wav	Wǣy syudbyar myattyuŋow:
/root/repos/dli_del/data/wav_split_gold/437.wav	paryeŋodah arădh nyabi ǣw yaŋgoda.
/root/repos/dli_del/data/wav_split_gold/1635.wav	Ti laanakoni pirda. 
/root/repos/dli_del/data/wav_split_gold/1388.wav	"Mănʹ ănmi anā anih nyudyercʹ anada maqniwq măncyaw yada ăyadmh,"
/root/repos/dli_del/data/wav_split_gold/1312.wav	Maqniwh:
/root/repos/dli_del/data/wav_split_gold/509.wav	"pulita yolcʹmăna maqniwq yah ŋilh lumbădanh sǣywi,"
/root/repos/dli_del/data/wav_split_gold/928.wav	"nyudyaawmh nyǎqămsadăwā, "
/root/repos/dli_del/data/wav_split_gold/445.wav	Wadyetin?
/root/repos/dli_del/data/wav_split_gold/1681.wav	" A Warңǣ, warңǣ? "
/root/repos/dli_del/data/wav_split_gold/121.wav	Tika(ko)cyai ŋănih măntǣyq. 
/root/repos/dli_del/data/wav_split_gold/1675.wav	Ti. 
/root/repos/dli_del/data/wav_split_gold/823.wav	"Tiki, tiki ŋăcyekǣr maqniwq mi,"
/root/repos/dli_del/data/wav_split_gold/1222.wav	"syoǒnda mǣira anih ŋulih onyedaănda, "
/root/repos/dli_del/data/wav_split_gold/1143.wav	yolʹcyey mǣyraqnidawq.  
/root/repos/dli_del/data/wav_split_gold/1158.wav	"«Mǣmi tyedah mǣqyaq,"
/root/repos/dli_del/data/wav_split_gold/836.wav	Ti orkih piruwna anyena ŋăcyekǣŋǣ ǣya.
/root/repos/dli_del/data/wav_split_gold/1596.wav	"Luciq, luciq anh siңǣy tyetǣy oramdaңǣy Salyeyakoyaqyeyңǣy ңilanda pyawidowңǣy taңi sǣlanaңǣy nyarmye lucidaңǣy lucandow anh siq. "
/root/repos/dli_del/data/wav_split_gold/736.wav	Tikimh nămdăăwa siqiw ăbir nyoh simh pida ǣqnidaqamh. 
/root/repos/dli_del/data/wav_split_gold/637.wav	Maqniwh: «Syanh tărcyadmh nidmh ŋǣŋguh».
/root/repos/dli_del/data/wav_split_gold/150.wav	"ti tʃtob tanyana pon' mǣŋguwa"" koralʹ mǣcʹ tara""."
/root/repos/dli_del/data/wav_split_gold/139.wav	"Lucid yada to""."
/root/repos/dli_del/data/wav_split_gold/193.wav	Tikaad ti ŋani ŋob' tim' oni'  
/root/repos/dli_del/data/wav_split_gold/660.wav	"Ti laănakor,"
/root/repos/dli_del/data/wav_split_gold/778.wav	Numh ŋǣryoyma. 
/root/repos/dli_del/data/wav_split_gold/408.wav	Nyonda si ŋanih tăqăyalʹnyah ŋǣwi. 
/root/repos/dli_del/data/wav_split_gold/196.wav	owǣmi'.
/root/repos/dli_del/data/wav_split_gold/1167.wav	"Taslaăya ŋobhyootah,"
/root/repos/dli_del/data/wav_split_gold/996.wav	Săbye ponh ninih yadh maqniwq syudbyako mandyabǣ(manyabǣ).
/root/repos/dli_del/data/wav_split_gold/1753.wav	 Ңumb-ya. 
/root/repos/dli_del/data/wav_split_gold/560.wav	«Wadid pirdoh?»  
/root/repos/dli_del/data/wav_split_gold/1679.wav	 Ңaa? 
/root/repos/dli_del/data/wav_split_gold/1280.wav	"maqniwq ŋămgǣ mutraăna adā săwă ŋǣdăki,"
/root/repos/dli_del/data/wav_split_gold/1643.wav	 Lǣqmoqrakow piyakor ta! 
/root/repos/dli_del/data/wav_split_gold/1493.wav	"nyawaq ŋanih tyuku, "
/root/repos/dli_del/data/wav_split_gold/1353.wav	"Tow asăwada mannaqmaq ŋobh,"
/root/repos/dli_del/data/wav_split_gold/1230.wav	"Măkodah siina tikăăna ŋǣda tiki yesya wădamh tyaănyaŋi piya yarăkoh mǣnh tyebdyeda, "
/root/repos/dli_del/data/wav_split_gold/194.wav	ŋani' taryem'. 
/root/repos/dli_del/data/wav_split_gold/1573.wav	" yesʹ ңuq mi yesʹ ңǣsoңotoh syerq ңud sandawa latar ңǣdaki nyaңǣdya myaq ңǣwi aniq, "
/root/repos/dli_del/data/wav_split_gold/28.wav	Piliq ponh oyh nih măncăralqnyowamh.
/root/repos/dli_del/data/wav_split_gold/826.wav	portyew tyuku mǣmdih. 
/root/repos/dli_del/data/wav_split_gold/365.wav	 sǣytadmh»
/root/repos/dli_del/data/wav_split_gold/757.wav	«Muŋgoqnaq ŋanih labtǣydoh tinyoq. 
/root/repos/dli_del/data/wav_split_gold/535.wav	"maqniwq piliq puda maqniwq taykuy myadmh ōdamcʹ,"
/root/repos/dli_del/data/wav_split_gold/632.wav	"nyudămda oyā anih maqniwq  tăryemh ŋămyǎmda nyoya syayq maqniwq nyukcyamda săwămbowna wadāmda maqniwq,  "
/root/repos/dli_del/data/wav_split_gold/940.wav	siqiw abărtyeqǣ tyaănyah tănqtănaq ti miŋaq tikawna.
/root/repos/dli_del/data/wav_split_gold/53.wav	Ŋuli' yadyembi.
/root/repos/dli_del/data/wav_split_gold/705.wav	"Yesya yarakomda ŋodʹh nyudya ăbir nyaqămă̌ŋgudasyā anih,"
/root/repos/dli_del/data/wav_split_gold/49.wav	oyh niymh yadri syurtyeqnisăwawh.
/root/repos/dli_del/data/wav_split_gold/998.wav	"yada,"
/root/repos/dli_del/data/wav_split_gold/864.wav	Ŋaat ti.
/root/repos/dli_del/data/wav_split_gold/839.wav	"ănya pida ŋǣ""niwh,"
/root/repos/dli_del/data/wav_split_gold/1504.wav	narǣyq nimqŋaq. 
/root/repos/dli_del/data/wav_split_gold/1232.wav	Syudbya wǣsăko tyormh nyadqmyacʹ nidawh nǣkălh.
/root/repos/dli_del/data/wav_split_gold/210.wav	"tad ŋaniabida sirŋǣ tabcor""ni""im'."
/root/repos/dli_del/data/wav_split_gold/292.wav	alʹmyerq?
/root/repos/dli_del/data/wav_split_gold/667.wav	Siqiw ăbir usuwǣy yalyah anyesyatiq. 
/root/repos/dli_del/data/wav_split_gold/1188.wav	"tiki muŋgar tikăana ŋǣqniwq yesyaăna urawiwa,"
/root/repos/dli_del/data/wav_split_gold/737.wav	"Pudăna ǣwǣmdoh ni wirkaădtāq,"
/root/repos/dli_del/data/wav_split_gold/1010.wav	"siqiw ăbărtaqyamh maqniwq,"
/root/repos/dli_del/data/wav_split_gold/1582.wav	 Malda. 
/root/repos/dli_del/data/wav_split_gold/1141.wav	tăryemgawh ŋămgǣ sit mǣmbăŋgudmh». 
/root/repos/dli_del/data/wav_split_gold/1019.wav	tyuku ŋamci săppa mǣtaqyami tiqyaqaw».
/root/repos/dli_del/data/wav_split_gold/1093.wav	Muŋgoh pyay ăbi tăryemh sirŋa yesya salh ǣwana ŋulih yalăndoh almyerq liq. 
/root/repos/dli_del/data/wav_split_gold/306.wav	"Ŋodʹbyatoh tyuku tid taryemh aq,"
/root/repos/dli_del/data/wav_split_gold/1570.wav	"anda nyana aya aniq, "
/root/repos/dli_del/data/wav_split_gold/1622.wav	Wǣy Lǣqmoqrakor inomdaңow maqniwq: 
/root/repos/dli_del/data/wav_split_gold/556.wav	"Ti tărcya ni taraq,"
/root/repos/dli_del/data/wav_split_gold/588.wav	"Ti, ti wǣwa ti»."
/root/repos/dli_del/data/wav_split_gold/388.wav	Tiki myath myath tyu.
/root/repos/dli_del/data/wav_split_gold/464.wav	"Maqniwq mi,"
/root/repos/dli_del/data/wav_split_gold/136.wav	Tănyad ŋǣdalyorka taydoh. 
/root/repos/dli_del/data/wav_split_gold/1609.wav	abiiyur yalyah anye nacyatiih. 
/root/repos/dli_del/data/wav_split_gold/845.wav	"orkita yes-ye mănǣqmăncʹ anda, "
/root/repos/dli_del/data/wav_split_gold/1122.wav	«Mănʹ păŋgălmǣmi sit manoŋgadmh».
/root/repos/dli_del/data/wav_split_gold/711.wav	«Tyukǒowar ŋămgǣ?
/root/repos/dli_del/data/wav_split_gold/1580.wav	Tyedah tǣri tyuku taryemh yeryemonda syerq syan laanakokocyaqyamh …
/root/repos/dli_del/data/wav_split_gold/149.wav	"""Tyeda' săwa myestadamd pyul-ina, "
/root/repos/dli_del/data/wav_split_gold/656.wav	Ti.» 
/root/repos/dli_del/data/wav_split_gold/1604.wav	 Sawaqyaqңǣy.
/root/repos/dli_del/data/wav_split_gold/345.wav	"Tǣwqmaădani ănyan tǣwraq,"
/root/repos/dli_del/data/wav_split_gold/1477.wav	"tikiyumh yaa ŋǣŋgō tănya ŋădʹbăta,"
/root/repos/dli_del/data/wav_split_gold/597.wav	«Tărcyah tănyaŋgobh mambqnanda piliq ponh tărcyawaq ŋǣŋguwaq» 
/root/repos/dli_del/data/wav_split_gold/349.wav	Tǣwiq.
/root/repos/dli_del/data/wav_split_gold/214.wav	Tikaad ŋob' tarcya 
/root/repos/dli_del/data/wav_split_gold/728.wav	"yalǣmdh păkal-yaqmaq tikimh pǣrăcʹ,"
/root/repos/dli_del/data/wav_split_gold/1172.wav	"«Tiki syudbyaqyami abtawh,"
/root/repos/dli_del/data/wav_split_gold/732.wav	"«Yebcotakon, "
/root/repos/dli_del/data/wav_split_gold/1449.wav	"nikanda ărmh soda,"
/root/repos/dli_del/data/wav_split_gold/1403.wav	iriini maqnidamh: 
/root/repos/dli_del/data/wav_split_gold/496.wav	pidoh tabyedawidoh. 
/root/repos/dli_del/data/wav_split_gold/958.wav	"Syudbya wǣsako toqniwq mimh mǣmda yadăbciyeqŋaq, "
/root/repos/dli_del/data/wav_split_gold/546.wav	tărcya nye tad nyernyah yaŋgobta tara maqniwq yah obah ninya.
/root/repos/dli_del/data/wav_split_gold/447.wav	 maqniwq.
/root/repos/dli_del/data/wav_split_gold/1321.wav	syenyǎna ărta nisyǎnda ŋin ŋǣqniwq [nyeracbortʃiwo].
/root/repos/dli_del/data/wav_split_gold/1664.wav	 A potom ǣto pro alyeya.
/root/repos/dli_del/data/wav_split_gold/725.wav	yabtkoyenh nyenǣy ŋulih». 
/root/repos/dli_del/data/wav_split_gold/98.wav	"Tiq ŋǣyaq, mimandoh syerh "
/root/repos/dli_del/data/wav_split_gold/1117.wav	Tiki syudbyar nyaarq sawna ibq păŋgălnidawh abǣyq ŋumqyaq tikiq.
/root/repos/dli_del/data/wav_split_gold/1640.wav	 Lǣqmoqrakow ңǣwakar taq! 
/root/repos/dli_del/data/wav_split_gold/791.wav	myadmh syurtye ăyā anih myakna so. 
/root/repos/dli_del/data/wav_split_gold/1231.wav	măncabtaybtyeda. 
/root/repos/dli_del/data/wav_split_gold/299.wav	"nyerdyenya tiki liq anyana ŋǣsaq, tiki nyaarq alʹmyer, "
/root/repos/dli_del/data/wav_split_gold/1012.wav	" syudbya yedănda tyeruwna tudodoh yaŋgaq, "
/root/repos/dli_del/data/wav_split_gold/1149.wav	"ŋilǣda tăsiy sǣryercăwǣyq măncadăŋga,"
/root/repos/dli_del/data/wav_split_gold/375.wav	«Tiki padăr ŋămgǣr?»
/root/repos/dli_del/data/wav_split_gold/41.wav	"Siqiw yuq măt"" po ŋǣwi ŋǣbtă."
/root/repos/dli_del/data/wav_split_gold/1583.wav	 Ilyeqmya  waalq. 
/root/repos/dli_del/data/wav_split_gold/611.wav	"usuwǣy nyamda poyomdambăda maqniwq,"
/root/repos/dli_del/data/wav_split_gold/1401.wav	Irini myadh nyana anaw. 
/root/repos/dli_del/data/wav_split_gold/387.wav	nyonda nyayunda nǣbyowi.
/root/repos/dli_del/data/wav_split_gold/1046.wav	 pida ŋilănada nyenǣy ŋămcaq.
/root/repos/dli_del/data/wav_split_gold/1078.wav	"«adabh tyenyewănăkǣdmh,"
/root/repos/dli_del/data/wav_split_gold/1654.wav	 Pro alyeya i pro woronu u myenya bilo. 
/root/repos/dli_del/data/wav_split_gold/1653.wav	 Malda. 
/root/repos/dli_del/data/wav_split_gold/1659.wav	 Aa.
/root/repos/dli_del/data/wav_split_gold/71.wav	raciyasawǣyq myaknih solamih.
/root/repos/dli_del/data/wav_split_gold/1226.wav	Muŋgoh pyay ăbi muncih tăryemh incyelyewa.
/root/repos/dli_del/data/wav_split_gold/1740.wav	 Manʹ obcow maqniwq myattyuwandan ңǣbat ңobh myattyuq pinh ǣwandan ңǣbat ңobh pinh anʹq salikami yesʹmya. 
/root/repos/dli_del/data/wav_split_gold/1615.wav	Sidya abiiyud tad manǣqңadih yewǣynih syancyoko ibya ңam-yada? 
/root/repos/dli_del/data/wav_split_gold/1194.wav	«Ŋobh nyenǣcʹh myattyu». 
/root/repos/dli_del/data/wav_split_gold/225.wav	tay'
/root/repos/dli_del/data/wav_split_gold/1601.wav	 [nyeracbortʃiwo]
/root/repos/dli_del/data/wav_split_gold/376.wav	"«Ŋa,  padmi, maqniwq,"
/root/repos/dli_del/data/wav_split_gold/947.wav	"Ŋopoy mungănh mǣyda,"
/root/repos/dli_del/data/wav_split_gold/1305.wav	ti ŋămcidoh ŋarkăkoqyaq  tyenyewaŋgudaq. 
/root/repos/dli_del/data/wav_split_gold/56.wav	"tʃtob taki raciyasawǣy nyenǣcyaŋgq mancʹ ǣsyǎtiwa,"
/root/repos/dli_del/data/wav_split_gold/1156.wav	"siqiw yalyah myaknanda oni,"
/root/repos/dli_del/data/wav_split_gold/809.wav	"Sălʹnyanda myuh pǣbtănakǣda ancyerlih pǣbtănakǣdā anih,"
/root/repos/dli_del/data/wav_split_gold/1402.wav	"Irini myadh nyana anaw,"
/root/repos/dli_del/data/wav_split_gold/327.wav	"Tyuku,"
/root/repos/dli_del/data/wav_split_gold/80.wav	ti pyelyeytada ăbtada ŋănih awi.
/root/repos/dli_del/data/wav_split_gold/569.wav	nye tunh» 
/root/repos/dli_del/data/wav_split_gold/212.wav	"ŋawradna"" wyertolyotana tǣri tad""la"", "
/root/repos/dli_del/data/wav_split_gold/796.wav	pinh anda myakna so.
/root/repos/dli_del/data/wav_split_gold/1700.wav	 Putkoni niyey ibyandowh putkow? 
/root/repos/dli_del/data/wav_split_gold/31.wav	ti Muŋguyăna syan ti po mǣnakǣwaq. 
/root/repos/dli_del/data/wav_split_gold/1341.wav	"nyenyaŋgq ŋǣdakiq,"
/root/repos/dli_del/data/wav_split_gold/935.wav	"tarsih maqniwq mayanyoh,"
/root/repos/dli_del/data/wav_split_gold/1462.wav	"Ti tărcyamh anā, "
/root/repos/dli_del/data/wav_split_gold/1016.wav	ancyerrih pinaya.
/root/repos/dli_del/data/wav_split_gold/289.wav	] Tyuku tiq alʹmyerq anyana ŋa? 
/root/repos/dli_del/data/wav_split_gold/1460.wav	"tănyǎ tyaăkuy tyuku miq ŋarq noyq labăsq mǣŋǣ mǣtaq ŋamdyorŋǣ yathmǣtaq,"
/root/repos/dli_del/data/wav_split_gold/1045.wav	"Syudbyanda ŋilh yalăndoh tudo pǣrŋa,"
/root/repos/dli_del/data/wav_split_gold/232.wav	"mi arwa""ni""im', "
/root/repos/dli_del/data/wav_split_gold/442.wav	Pidăr syerl niŋaq.
/root/repos/dli_del/data/wav_split_gold/176.wav	"Yesli tyempyeraturada yaŋgoda, tikar ti mi wuni ŋa"". "
/root/repos/dli_del/data/wav_split_gold/1023.wav	pidăr widărăbqnand yoŋgămd săpăŋguw». 
/root/repos/dli_del/data/wav_split_gold/191.wav	"tikaad taryem' siwaana sabka niw' tara,"
/root/repos/dli_del/data/wav_split_gold/1301.wav	"tidǣh malăna  yaah nyayuh lǣbta tikaăna syudbyako mi ŋamdi,"
/root/repos/dli_del/data/wav_split_gold/951.wav	maănda nyād syudbyako pisʹh niwh ŋădarh. 
/root/repos/dli_del/data/wav_split_gold/1711.wav	Pida poyorcʹ aya aniq ǣwanyawa aniq. 
/root/repos/dli_del/data/wav_split_gold/1290.wav	"mǣ yaah nyah lǣbtăŋgo, "
/root/repos/dli_del/data/wav_split_gold/390.wav	"Ŋobh nye aniq,"
/root/repos/dli_del/data/wav_split_gold/373.wav	Maqniwq:
/root/repos/dli_del/data/wav_split_gold/966.wav	"«Măncyaw adami tănya anih,"
/root/repos/dli_del/data/wav_split_gold/1138.wav	"«Pirar ŋǣsa,"
/root/repos/dli_del/data/wav_split_gold/967.wav	adămi ni mancyetuh taki mi paryeŋodah yawna syudbya maqniw nyar ăbărtaaqnaq ŋǣdali».
/root/repos/dli_del/data/wav_split_gold/1071.wav	nyenǣcyah ŋămcaaw yath ŋăwăr wuniŋaq».
/root/repos/dli_del/data/wav_split_gold/1211.wav	"Ŋămgǣh piruwna ŋǣbqnanda ŋodh wǣsăkoqyaq săwuma,"
/root/repos/dli_del/data/wav_split_gold/1750.wav	 Tiiyuda nyuuda tikad mi. 
/root/repos/dli_del/data/wav_split_gold/718.wav	tăsina salăba ŋămgǣdiki yayolh tănyawăki».
/root/repos/dli_del/data/wav_split_gold/1595.wav	" Ti, syanmboy wadakoda tiki syomh mǣqmih. "
/root/repos/dli_del/data/wav_split_gold/1109.wav	Tikămda osʹ niwh yaqamh.
/root/repos/dli_del/data/wav_split_gold/77.wav	"Mănʹ sămlyaŋg timh mǣqŋaqdamcʹ, "
/root/repos/dli_del/data/wav_split_gold/1322.wav	"Ti myakanda aya anih tădawa,"
/root/repos/dli_del/data/wav_split_gold/1136.wav	syudbyako yesya salanh tyebwanda syerh yesyamh pyata tibkah tucyeyq wirkădaq.
/root/repos/dli_del/data/wav_split_gold/806.wav	Tad tănyah tiki syudbyako lăbtǣymh tad nǣwăda yaananda ŋăyebǣy ŋacyeki tikăana lyasi.  
/root/repos/dli_del/data/wav_split_gold/695.wav	"Puucya sǣwda ǣwnyah mǣyda,"
/root/repos/dli_del/data/wav_split_gold/733.wav	"siqiw abi, "
/root/repos/dli_del/data/wav_split_gold/1443.wav	"wǣnq ŋǣdakiq,"
/root/repos/dli_del/data/wav_split_gold/601.wav	maqniwq.
/root/repos/dli_del/data/wav_split_gold/1314.wav	Ti maqniwq: 
/root/repos/dli_del/data/wav_split_gold/1135.wav	"ăcyah syurămba nyambor ŋămgǣq taykuh miŋgăda ŋuwocyaiq ŋămgǣda tănya,"
/root/repos/dli_del/data/wav_split_gold/1170.wav	Myakănda ŋanih ăya.
/root/repos/dli_del/data/wav_split_gold/1695.wav	ңariq todoowq myeryeqңayoow! 
/root/repos/dli_del/data/wav_split_gold/1077.wav	andanăwa myat tyenyewawăwa».
/root/repos/dli_del/data/wav_split_gold/1629.wav	“ancyerq siqmi watorpin maqniwq.q
/root/repos/dli_del/data/wav_split_gold/1293.wav	"Ti lukq ŋamdyodāq aniq mǣ̄ nyānd sirtaq maqniwq mi mi ti orkiq totryewh tiki nyānd tǣri sirtaqmaq,"
/root/repos/dli_del/data/wav_split_gold/1537.wav	"Punaaw syaqniqrinda unananda ŋǣbqnanda ŋodh,"
/root/repos/dli_del/data/wav_split_gold/768.wav	maqniwq. 
/root/repos/dli_del/data/wav_split_gold/1709.wav	Tadaw nyaanda maqniwq tiki mi:
/root/repos/dli_del/data/wav_split_gold/474.wav	"Maqniwq mi,"
/root/repos/dli_del/data/wav_split_gold/112.wav	tʃtobi myuyda mănǣqmăncʹ. Tikanda utʃyerq (ăncyerq) ayoda?» 
/root/repos/dli_del/data/wav_split_gold/1063.wav	ŋăwǣd pǣrcyatin ilyewand yambănh?» 
/root/repos/dli_del/data/wav_split_gold/1206.wav	Pyelyeynyana maqniwq ŋopoy asăwa nyuda piya yarakoqyaq. 
/root/repos/dli_del/data/wav_split_gold/38.wav	"Tăd tikaăd tayna, tyuku taqălʹnyana măncăradmh, tă inkih nyakuna mǣwacʹ."
/root/repos/dli_del/data/wav_split_gold/1610.wav	Ңawi syaqniq ңǣbta ңodh Lǣqmoqrakor abiiyuta myath aya
/root/repos/dli_del/data/wav_split_gold/1037.wav	tǣdorcyǎtida iriqyaqămda.
/root/repos/dli_del/data/wav_split_gold/1094.wav	"almyerq ŋǣwaq, "
/root/repos/dli_del/data/wav_split_gold/919.wav	"siqiw ăbi tănyasʹ,"
/root/repos/dli_del/data/wav_split_gold/1547.wav	"Ti tikand nye abtărka ŋǣqniwq Noy mărădyaŋgănd nye,"
/root/repos/dli_del/data/wav_split_gold/1718.wav	 Tiki oqryeqǣr maqniwq taki pidaramh maniyer? 
/root/repos/dli_del/data/wav_split_gold/252.wav	"Tyedah taryemh padnawad amgǣh tyuquq nyana tyedah namdaŋgudoh, tandayah pisaŋgudq. "
/root/repos/dli_del/data/wav_split_gold/992.wav	Muŋgoq pyay ăbi ŋopoy ilwah tyaah siqiw ăbărtamh maanda nyah sakăadtǣydā mărcyanda lih nih.
/root/repos/dli_del/data/wav_split_gold/930.wav	"ŋămgǣǣrtăna,"
/root/repos/dli_del/data/wav_split_gold/1550.wav	pǣdăraana tăryemh ilyewaănda tiki ŋacyekǣcyar niqimh yadǣlq.
/root/repos/dli_del/data/wav_split_gold/802.wav	"ti munda nyudyambowa,"
/root/repos/dli_del/data/wav_split_gold/507.wav	Maqniwq tiki yawh ǣwăd ǣqmyaadani maqniwq ŋobh yadnamh syurămbădaqyamh măqnǣqdămcʹ.
/root/repos/dli_del/data/wav_split_gold/936.wav	tyuku ŋanih ăya».
/root/repos/dli_del/data/wav_split_gold/310.wav	"] Syeytʃas sprosim, ya dumayu. "
/root/repos/dli_del/data/wav_split_gold/1250.wav	tyedaărth tyebdyeir».
/root/repos/dli_del/data/wav_split_gold/880.wav	«Ta syayqnidamh».
/root/repos/dli_del/data/wav_split_gold/1479.wav	piliq widăra.
/root/repos/dli_del/data/wav_split_gold/1652.wav	 malda? 
/root/repos/dli_del/data/wav_split_gold/422.wav	"«uh yabtkoyen ŋuliq man-in, man-in:"
/root/repos/dli_del/data/wav_split_gold/1006.wav	"ŋaaq, pyadăr mǣq tur pyataq,"
/root/repos/dli_del/data/wav_split_gold/538.wav	maqniwq maqniwq ŋămyeǣyuda păradambăda nyemh odmh.
/root/repos/dli_del/data/wav_split_gold/1004.wav	"pidăr pǣdăra yah tyerăn ninawh ŋaq,"
/root/repos/dli_del/data/wav_split_gold/1070.wav	"«Nyenǣciyeq ŋămcari ninawh ŋaworq ilyewand yambanh,"
/root/repos/dli_del/data/wav_split_gold/892.wav	"Ti, Muŋgoq pyay ăbi yesya yarăkocyah myu saaltasʹ tiki păsih nyu tiki tǣ tuyesăr tyuquq nyah ŋanih loomba tolih. "
/root/repos/dli_del/data/wav_split_gold/47.wav	"Ti mălyaŋgi, tamălyaŋgǣǣd măncărawi, măncara tyedah ti ŋudini ŋǣyaq, "
/root/repos/dli_del/data/wav_split_gold/1589.wav	 Nyund nyukubc tyeda [nyeracbortʃiwo]. 
/root/repos/dli_del/data/wav_split_gold/1636.wav	[nyeracbortʃiwo]
/root/repos/dli_del/data/wav_split_gold/1155.wav	"[nyeracbortʃiwo] myakănda ăya,"
/root/repos/dli_del/data/wav_split_gold/1581.wav	 Tyukond ti malda? 
/root/repos/dli_del/data/wav_split_gold/493.wav	"Maqniwq wǣbărkar tărcya maqniwq,"
/root/repos/dli_del/data/wav_split_gold/623.wav	"maqniwq pumnanih nidawh moh,"
/root/repos/dli_del/data/wav_split_gold/512.wav	Nyani maqnisawh man-in.
/root/repos/dli_del/data/wav_split_gold/877.wav	"«Ta ānyeh,"
/root/repos/dli_del/data/wav_split_gold/740.wav	tiki nyūdya ŋămgǣh yeqǣ̌mnya ŋǣdăraŋguda?
/root/repos/dli_del/data/wav_split_gold/633.wav	ărta owǣda nyuda ŋǣqniwh».
/root/repos/dli_del/data/wav_split_gold/1562.wav	Myakandih anadih. 
/root/repos/dli_del/data/wav_split_gold/22.wav	Karaulănh pyeryeʃyol pyatiy klassănh.
/root/repos/dli_del/data/wav_split_gold/766.wav	siqmi ŋǣdăraq. 
/root/repos/dli_del/data/wav_split_gold/1052.wav	"Yaah lăŋgaăna ŋamdǣ̄ anih, "
/root/repos/dli_del/data/wav_split_gold/811.wav	Piwaawaăwada ŋoka taŋok nyenǣciyeq ada tǒurh ŋǣdaki ilyewanda yambănh măqlămbăwida. 
/root/repos/dli_del/data/wav_split_gold/471.wav	maqniwq yewăkoot yeǣraŋaah.
/root/repos/dli_del/data/wav_split_gold/783.wav	"«Ŋămgǣdăni taromna ŋǣdărawǣǣyain, "
/root/repos/dli_del/data/wav_split_gold/1128.wav	ŋulih pǣbtaqnidawh. 
/root/repos/dli_del/data/wav_split_gold/1413.wav	"myuykonda pyelyakăimh,"
/root/repos/dli_del/data/wav_split_gold/1355.wav	"ānda siid laăna,"
/root/repos/dli_del/data/wav_split_gold/411.wav	"Ti ŋǣǣ̌yuda tuh sidya ǣwuwna mǣwǣǣyudā aniq,"
/root/repos/dli_del/data/wav_split_gold/735.wav	maqniwq irinataq nisyanataq ŋǣw ŋamiq ŋanih siqiw abtēqǣ maqniwq ŋanih sǣwaqni aqmidh».
/root/repos/dli_del/data/wav_split_gold/854.wav	«Ŋămgǣ sidyambonih tyedananih?»
/root/repos/dli_del/data/wav_split_gold/912.wav	maqniwq wadyetănakin ŋulyēq».
/root/repos/dli_del/data/wav_split_gold/1315.wav	«Ŋămcaănda tyebbăqnanda maqniwq an». 
/root/repos/dli_del/data/wav_split_gold/2.wav	"Pada ni yutʃitʹq (Pida ni yusidaq), "
/root/repos/dli_del/data/wav_split_gold/401.wav	«Pǐr(pidăr) anyah pyar?»
/root/repos/dli_del/data/wav_split_gold/898.wav	«Ti ŋamgǣǣrt salăba ŋamgǣǣrt salăba yǎŋgō anih».
/root/repos/dli_del/data/wav_split_gold/1426.wav	"yesyaana taă̌rawi,"
/root/repos/dli_del/data/wav_split_gold/92.wav	"Tăkad tăd silasyatiwa"" manbtǣwiq yah obamh abrawaq,"
/root/repos/dli_del/data/wav_split_gold/187.wav	"tyeda' laana nyanani ŋǣ""ya""ŋa."
/root/repos/dli_del/data/wav_split_gold/66.wav	"Ŋobh pyaaya, tănyah tǣwinih tiki kak rac,"
/root/repos/dli_del/data/wav_split_gold/222.wav	ŋokam' wunin ŋawort' tǣri ŋob' sidya syarkam' ŋaman masʹ. 
/root/repos/dli_del/data/wav_split_gold/897.wav	«Ti mi salăba myunanda ŋǣwaki».
/root/repos/dli_del/data/wav_split_gold/433.wav	Maqniwq ti yesya arwămda tǣwqmaădănda ti madaŋguqnidaqămhniduqǔmh aniq.
/root/repos/dli_del/data/wav_split_gold/622.wav	"Siirtyar pinh niqimh cyurbǣq anih,"
/root/repos/dli_del/data/wav_split_gold/673.wav	Pyelyeyh nyana tikidoh cilpiq yalyah yambănh.
/root/repos/dli_del/data/wav_split_gold/97.wav	Tikād (tikaăd) wǣnyekud ŋǣyaq.
/root/repos/dli_del/data/wav_split_gold/30.wav	"Ti ŋămgǣh pirathmăncarawaq tănyana, "
/root/repos/dli_del/data/wav_split_gold/265.wav	Tyeda ti ibyaart ibyaart ni punryuq. Ti.
/root/repos/dli_del/data/wav_split_gold/1435.wav	Ti tikăawaad tyey nyedah myumnya taminda yaamh mădănakǣda ănyada mădah ŋămgǣh.
/root/repos/dli_del/data/wav_split_gold/353.wav	Yǎtrih syurămbi tănya ŋadʹbăta yath.
/root/repos/dli_del/data/wav_split_gold/659.wav	Ŋulih  puucya.
/root/repos/dli_del/data/wav_split_gold/1430.wav	maqniwq mi: 
/root/repos/dli_del/data/wav_split_gold/179.wav	ŋǣsiinando'. 
/root/repos/dli_del/data/wav_split_gold/1205.wav	Syudbyani myakna mălye syanh tyukǒona ilyebaqni ŋodh maqniwq syudbyah nye nyuh waqăwana.
/root/repos/dli_del/data/wav_split_gold/1540.wav	"ănoh tirănăwah yolʹcyǎŋgăna, "
/root/repos/dli_del/data/wav_split_gold/1339.wav	"tah ŋǣdakiq,"
/root/repos/dli_del/data/wav_split_gold/943.wav	siqiw taŋocyah tyer ŋawoqmaadăndaq maqniwq ti maqniwq ăbărtaq yeryemyaq tyedah maqniwaq».
/root/repos/dli_del/data/wav_split_gold/1587.wav	Nyeңǣ anyoq Miniko Miniko ayeda. 
/root/repos/dli_del/data/wav_split_gold/206.wav	"nyankoda,"
/root/repos/dli_del/data/wav_split_gold/1699.wav	 Putkodanih putkoonih! 
/root/repos/dli_del/data/wav_split_gold/257.wav	"tamalyaŋgiq tikiq ŋaat yadǣrmiq, "
/root/repos/dli_del/data/wav_split_gold/1536.wav	numh sirǣymawa tiki asăwar.
/root/repos/dli_del/data/wav_split_gold/1513.wav	"tiki nyemh pǣŋada anih, tyeǣ madrota yaah ǣwanhanada. "
/root/repos/dli_del/data/wav_split_gold/321.wav	Tyedaq Siirtya ănyah pyar?
/root/repos/dli_del/data/wav_split_gold/1487.wav	"Yeǣy, laănăkor tyeǣ miq nyana ăyow,"
/root/repos/dli_del/data/wav_split_gold/1318.wav	"Tiki lukămd taslaăya tad pitărmanda yaanda tyuku mǣqyada ti orkih piyǎraa niwŋaq aniq, "
/root/repos/dli_del/data/wav_split_gold/1331.wav	nyah tăryemh oda Miniko.
/root/repos/dli_del/data/wav_split_gold/400.wav	"Maqniwq, Siirtyanh maqniw:"
/root/repos/dli_del/data/wav_split_gold/275.wav	ŋa nyewiq tiki nyenǣcyaq.
/root/repos/dli_del/data/wav_split_gold/1306.wav	Ti.
/root/repos/dli_del/data/wav_split_gold/154.wav	"pyaŋgu"" pyaŋgu""ni""wa""am'. "
/root/repos/dli_del/data/wav_split_gold/430.wav	"Maqniwq yesya arw,"
/root/repos/dli_del/data/wav_split_gold/61.wav	"Tăd tikaăd ti brigadirmi maqnyu"": "
/root/repos/dli_del/data/wav_split_gold/1258.wav	"uŋgonda mih tyaah, "
/root/repos/dli_del/data/wav_split_gold/1095.wav	almyerq liq ŋulih ŋaranda ŋulih tikaăna ŋaq.
/root/repos/dli_del/data/wav_split_gold/424.wav	" wadyet, siqmi wadyesq». "
/root/repos/dli_del/data/wav_split_gold/434.wav	"Maqniwq mǣ uyuh nyah awăŋgu maqniwq mi,"
/root/repos/dli_del/data/wav_split_gold/1375.wav	"Tiki abtyeăbida tiki yaah yerʹh tad widărawadih yaănandih,"
/root/repos/dli_del/data/wav_split_gold/1386.wav	"«Mad măncyaw yada tutadmh, "
/root/repos/dli_del/data/wav_split_gold/1419.wav	Maqniwq mi:
/root/repos/dli_del/data/wav_split_gold/747.wav	"«Sit nidmh ŋǣdăraŋguh,"
/root/repos/dli_del/data/wav_split_gold/1140.wav	"«Yǎŋgu tǣri syanakunima,"
/root/repos/dli_del/data/wav_split_gold/57.wav	tinaq tăryemh ăyaq. 
/root/repos/dli_del/data/wav_split_gold/661.wav	nyero yaah ǣwana siqiw ăbi.
/root/repos/dli_del/data/wav_split_gold/1209.wav	"Tuh ŋǣǣyuda tuh sidya ǣwuwna mǣŋguuyuda maqniwq myata tyaănyaŋi ǣw maqniwq ŋopoyriŋǣ nyāănda masʹ,"
/root/repos/dli_del/data/wav_split_gold/1081.wav	"«Ta, ănyana ŋa asryor,"
/root/repos/dli_del/data/wav_split_gold/786.wav	Sidyowondasʹ.
/root/repos/dli_del/data/wav_split_gold/534.wav	"Siirtya maqniwq nin mălyeq,"
/root/repos/dli_del/data/wav_split_gold/900.wav	"ŋilʹnyād loomba,"
/root/repos/dli_del/data/wav_split_gold/144.wav	"nya""marpa pya""."
/root/repos/dli_del/data/wav_split_gold/690.wav	"Nyermya toqyada tah ŋar,"
/root/repos/dli_del/data/wav_split_gold/1720.wav	 A maqniwq tiki pǣdarar anyana aya? 
/root/repos/dli_del/data/wav_split_gold/230.wav	"Ti wǣnyeko"" ŋǣya"" mal' tǣsawǣy' parada""ni""na""am'."
/root/repos/dli_del/data/wav_split_gold/1676.wav	"	yeyeye."
/root/repos/dli_del/data/wav_split_gold/1454.wav	tuhyesya tănyasʹ. 
/root/repos/dli_del/data/wav_split_gold/46.wav	Ti.
/root/repos/dli_del/data/wav_split_gold/51.wav	ti tiq awah mălyaŋgăna. 
/root/repos/dli_del/data/wav_split_gold/734.wav	"maqniwq ŋămgǣmh manǣtadmh maqniwq tăŋocyamaq tyersinyoq maqniwq,"
/root/repos/dli_del/data/wav_split_gold/83.wav	Tărsih mintaart ni anash. 
/root/repos/dli_del/data/wav_split_gold/1031.wav	"Tikămda makănda mǣda,"
/root/repos/dli_del/data/wav_split_gold/8.wav	Ʃamyan mac-yam maldambi. (Syamyan măncayam’ maldambi). 
/root/repos/dli_del/data/wav_split_gold/1236.wav	Piya yarăkond maqniwq mǣda sooh sidya yaduwna maqniwq sidya yutyekăda măntircʹ ǣbyanondih. 
/root/repos/dli_del/data/wav_split_gold/476.wav	"Maqniwq tikaah ayuqmaăd păriqyaq  odămcʹ,"
/root/repos/dli_del/data/wav_split_gold/675.wav	Nyudya ăbir maqniwq: 
/root/repos/dli_del/data/wav_split_gold/127.wav	ănyanido' sracu lyeǣbtǣyadh. 
/root/repos/dli_del/data/wav_split_gold/1346.wav	"Nyumdya anih Tuh yash putko,"
/root/repos/dli_del/data/wav_split_gold/1439.wav	Wih tyer ilyenya nyenǣcyaŋǣ nirawinyoq anʹh.
/root/repos/dli_del/data/wav_split_gold/539.wav	Tiki ŋămyeǣyuda turinh păradambiiyuda maqniwq.
/root/repos/dli_del/data/wav_split_gold/363.wav	"Ti, maqniwq:"
/root/repos/dli_del/data/wav_split_gold/557.wav	tiki ŋămyeda părădambăda ni tara maqniwq. 
/root/repos/dli_del/data/wav_split_gold/1115.wav	"Tikanda yambanh syudbyamh tǣdorpiwa, "
/root/repos/dli_del/data/wav_split_gold/1552.wav	"ŋǣryoyq ŋǣwiq anih, "
/root/repos/dli_del/data/wav_split_gold/805.wav	Tiki puucyar ŋămgǣmh ŋătyeŋgu? 
/root/repos/dli_del/data/wav_split_gold/1458.wav	ulcopa pya.
/root/repos/dli_del/data/wav_split_gold/911.wav	"«ǣyyaǣyq, maqniwq nyenaq yaqăwlyanyoq,"
/root/repos/dli_del/data/wav_split_gold/344.wav	«Wadăkoinaq tǣwrain».
/root/repos/dli_del/data/wav_split_gold/816.wav	"Yaah lăŋgh nya pisyedyeda, ŋaaq."
/root/repos/dli_del/data/wav_split_gold/1224.wav	Mănʹ ăyadmh. 
/root/repos/dli_del/data/wav_split_gold/1151.wav	«Ti – madmh – tikăana miq». 
/root/repos/dli_del/data/wav_split_gold/808.wav	Tiki puucyar tinyoh tikaad ŋămgǣmda ŋatyeŋgu makănda nyaqămnakǣda.
/root/repos/dli_del/data/wav_split_gold/1590.wav	 Miid ңodh mǣtʹtinaq(mǣcyatdinaq) niqimңaq tyedah anyaңǣǣna yabye aңolasʹtida tikid nyenǣy yath. 
/root/repos/dli_del/data/wav_split_gold/1533.wav	Maqniwq:
/root/repos/dli_del/data/wav_split_gold/1327.wav	mi nyah tăryemh oda Miniko.
/root/repos/dli_del/data/wav_split_gold/708.wav	tiki yedăr ŋilʹnyād loombăda itryewh tyuquq nyah păromba tolih.
/root/repos/dli_del/data/wav_split_gold/1317.wav	Muŋgoh pyay ăbi tănyaŋi ǣwănda tănăwanda syerh nyenǣsyanda ŋodh tikăana luk ŋamdi.
/root/repos/dli_del/data/wav_split_gold/1436.wav	"Tad yalmanda tah yambă̌ana yadāwa,"
/root/repos/dli_del/data/wav_split_gold/937.wav	"Ti, Muŋgoq pyay ăbi laănăkomh nidawh anowh. "
/root/repos/dli_del/data/wav_split_gold/311.wav	"] A, Olyeg Yambanowitʃ, a kakoy god wot ǣto bilo?"
/root/repos/dli_del/data/wav_split_gold/890.wav	"Tyukumh ti yedmh, "
/root/repos/dli_del/data/wav_split_gold/1165.wav	"yesya sălămda syudǣǣyuta poŋgăna nyǎlonda miŋa tănya ŋădʹbăta, "
/root/repos/dli_del/data/wav_split_gold/913.wav	"«Măncyaw maqniwq aŋguqnidamh, "
/root/repos/dli_del/data/wav_split_gold/463.wav	– ŋuliq talyeyah»  maqniwq.
/root/repos/dli_del/data/wav_split_gold/1728.wav	 Tiki manyepǣr anyana aya? 
/root/repos/dli_del/data/wav_split_gold/1598.wav	Pida tida taki wacʹ mǣqңaqmaq yesi matorpa. 
/root/repos/dli_del/data/wav_split_gold/1229.wav	Ma yǎnambowna tyuquq yurkiq. 
/root/repos/dli_del/data/wav_split_gold/821.wav	Puucya puucyaŋǣ ǣqniwh nyenǣy.
/root/repos/dli_del/data/wav_split_gold/1114.wav	«Păncyerpaqnand myaknand pancyeqǣ̌d adaid». 
/root/repos/dli_del/data/wav_split_gold/498.wav	tăd tăd anăbătoh tiki alyamd syaŋokq mi yāmh yamh pyerămar   tikiwād ibidoh iridoh mǣqŋaq.
/root/repos/dli_del/data/wav_split_gold/263.wav	[...] Ti.
/root/repos/dli_del/data/wav_split_gold/335.wav	Masidoh mălye uwq.
/root/repos/dli_del/data/wav_split_gold/1195.wav	"Maqniw, "
/root/repos/dli_del/data/wav_split_gold/1281.wav	"siqmi tabyedaq,"
/root/repos/dli_del/data/wav_split_gold/240.wav	"yedǣy yan' ŋǣdatǣydoncʹ, "
/root/repos/dli_del/data/wav_split_gold/313.wav	"] A, i ǣto cnatʃit bilo... ǣǣǣ "
/root/repos/dli_del/data/wav_split_gold/499.wav	Yah tyerq nyenǣcʹq maqniwq pidoh yeqǣ̌mnyandoh sǣrdănh awanh ărwaq maqniwq tiki alyamd tăd wǣnoōltaŋgudoh maqniwh. 
/root/repos/dli_del/data/wav_split_gold/185.wav	"Manʹ ti tamalyaŋgana oy' nyenǣcyandm' nidam' ŋa"", nyatami tuŋgo' tiki yerwami. "
/root/repos/dli_del/data/wav_split_gold/466.wav	"Maqniwq, "
/root/repos/dli_del/data/wav_split_gold/88.wav	"Tă tă ŋămgǣǣw toh war, "
/root/repos/dli_del/data/wav_split_gold/308.wav	Mandaraacyaqnyoq ponh ilye 
/root/repos/dli_del/data/wav_split_gold/1476.wav	"tiki ŋǣsʹ tara,"
/root/repos/dli_del/data/wav_split_gold/760.wav	«Tiki muŋgo manǣsăr-in
/root/repos/dli_del/data/wav_split_gold/706.wav	nyaqămă̌da. 
/root/repos/dli_del/data/wav_split_gold/325.wav	"wadăkoyewaq tǣwrain, "
/root/repos/dli_del/data/wav_split_gold/1338.wav	"Tǣǣbini tini maqniwq ti ŋǣqniwh,"
/root/repos/dli_del/data/wav_split_gold/1746.wav	 Tikar mi simci 
/root/repos/dli_del/data/wav_split_gold/932.wav	Iinda maqniwq:˜
/root/repos/dli_del/data/wav_split_gold/317.wav	Uuq. 
/root/repos/dli_del/data/wav_split_gold/4.wav	"Săwawna macraaa (săwawna măncara), "
/root/repos/dli_del/data/wav_split_gold/503.wav	syaăh maqniwq wǣbărka ŋanih yǎŋgoda.
/root/repos/dli_del/data/wav_split_gold/10.wav	ʃunraa(syunraa) ŋodya pir.  
/root/repos/dli_del/data/wav_split_gold/81.wav	"Mi myerh nuliq myeryesqnyu"", "
/root/repos/dli_del/data/wav_split_gold/792.wav	Tad pinh ǣsyati piina so sih nyana.
/root/repos/dli_del/data/wav_split_gold/514.wav	Talyey nyenǣcʹh maqniwq.
/root/repos/dli_del/data/wav_split_gold/1214.wav	"Muŋgoh pyay ăbi,"
/root/repos/dli_del/data/wav_split_gold/1656.wav	 Yaydamyeǣyq pukdamyeǣyq ңariq todoowq myeryeqңayoow nyerdandoow lyeǣbtǣyeǣyq sibyalyaңgǣǣy marǣyh oboow.
/root/repos/dli_del/data/wav_split_gold/1272.wav	"Tădawa,"
/root/repos/dli_del/data/wav_split_gold/1532.wav	«Ilyeǣwa ilyen?» 
/root/repos/dli_del/data/wav_split_gold/1638.wav	" adakaabini syaaq tawnyan, "
/root/repos/dli_del/data/wav_split_gold/1511.wav	Yudyomda orqŋaq tarsiq ilye.
/root/repos/dli_del/data/wav_split_gold/679.wav	Ŋarka ăbir manda:
/root/repos/dli_del/data/wav_split_gold/562.wav	" «Tikih pudā ŋani ŋopoy myadmh odamcʹ anih,"
/root/repos/dli_del/data/wav_split_gold/775.wav	wunisyamah.
/root/repos/dli_del/data/wav_split_gold/879.wav	mi siqmi nin syayh?».
/root/repos/dli_del/data/wav_split_gold/578.wav	tiki toqǒla nye».
/root/repos/dli_del/data/wav_split_gold/1692.wav	Lorcǣy Lorcǣy! 
/root/repos/dli_del/data/wav_split_gold/1564.wav	"Tiki yaad tadawa ti Noy mărădyaŋg anh wǣynyah ңacyekimh ңabtadawa,"
/root/repos/dli_del/data/wav_split_gold/1086.wav	yal-yaah asryeqǣqăndih.
/root/repos/dli_del/data/wav_split_gold/1380.wav	"Yendh anada anih to asăwada sidya sǣrmh mǣta yat ănyad ŋămgǣ̌ǣd tobqnanda ŋodh,"
/root/repos/dli_del/data/wav_split_gold/669.wav	yalăndoh asăwamboyh ŋǣqnimh.
/root/repos/dli_del/data/wav_split_gold/954.wav	wǣwăko syermh syertan tădaw?»
/root/repos/dli_del/data/wav_split_gold/612.wav	"usuwǣy maqniwq ya yāmh,"
/root/repos/dli_del/data/wav_split_gold/648.wav	"«Mǣr maqniwq,"
/root/repos/dli_del/data/wav_split_gold/1030.wav	matq piya sănoorh. 
/root/repos/dli_del/data/wav_split_gold/143.wav	"orpa pya"", "
/root/repos/dli_del/data/wav_split_gold/360.wav	"ǣwuwnanda aya, Siirtyar,"
/root/repos/dli_del/data/wav_split_gold/1509.wav	"Tăd tayh mǣdā,"
/root/repos/dli_del/data/wav_split_gold/432.wav	yesya arwă̌da ayerta tălāda. 
/root/repos/dli_del/data/wav_split_gold/175.wav	Ti.
/root/repos/dli_del/data/wav_split_gold/822.wav	Maqniwq: «adami ŋulih puucyaŋǣ ăya».
/root/repos/dli_del/data/wav_split_gold/1043.wav	"Ŋandowh, yedămda tyedada yah ni soqǒyda nyaŋǣdya siqiw ăbărtămh piryeqmaq niqimŋaq tiki yed ŋămgǣh ăncyerq ŋǣdakǣ̄ anih,"
/root/repos/dli_del/data/wav_split_gold/742.wav	tiki malh ayaq matq ăbiiw.
/root/repos/dli_del/data/wav_split_gold/1468.wav	Ŋǣwarinda syerh  yal-yeq(yadăl-yeq).
/root/repos/dli_del/data/wav_split_gold/1600.wav	 Ңaaq. 
/root/repos/dli_del/data/wav_split_gold/1334.wav	Siqiw yurq uryodah tǣda siqiw yonarq.
/root/repos/dli_del/data/wav_split_gold/296.wav	"mih tih Pyelyadkah amgǣǣwh ŋilʹnyakuna, "
/root/repos/dli_del/data/wav_split_gold/558.wav	Wadini maqniw tiki puda [nyeracbortʃiwo] wadyetidaqmaq.
/root/repos/dli_del/data/wav_split_gold/1526.wav	"Ti niwŋaq, syowna anta ŋăwăr tănyaŋawq? "
/root/repos/dli_del/data/wav_split_gold/861.wav	Muŋgoq pyay abi lǣdǣmda yolʹcyedō.
/root/repos/dli_del/data/wav_split_gold/1255.wav	tiki păsih nyu puucyaqyada ŋanih onărawih. 
/root/repos/dli_del/data/wav_split_gold/570.wav	«Tiki?
/root/repos/dli_del/data/wav_split_gold/1024.wav	«Taslār?»  maqniwq.
/root/repos/dli_del/data/wav_split_gold/517.wav	maqniwq.
/root/repos/dli_del/data/wav_split_gold/1389.wav	yada ăyadmh. 
/root/repos/dli_del/data/wav_split_gold/1182.wav	"Ti maqniwq: «Ilyewah yambănh tǣwodăwǣmi ow maqniwq nyero yaah tyer ŋăwoqmami maqniwq ŋarănda ŋawoqmaădani tyedah maqniwq ti,"
/root/repos/dli_del/data/wav_split_gold/17.wav	Muŋguyăna 
/root/repos/dli_del/data/wav_split_gold/1203.wav	«iy yōo maqniwq tadawa maqniwq ancyerq tăryerkamh tadyebya ŋǣya».
/root/repos/dli_del/data/wav_split_gold/418.wav	"«Torŏwah, Siirtya, anyah pyar?» "
/root/repos/dli_del/data/wav_split_gold/361.wav	tika maqniwq:
/root/repos/dli_del/data/wav_split_gold/1465.wav	nyaarq ŋămgǣrimh anā.
/root/repos/dli_del/data/wav_split_gold/91.wav	tyuquy yah obamh ăbărŋadoh. 
/root/repos/dli_del/data/wav_split_gold/1365.wav	mari yesida ǣnyakiq tikăad yaaq ăyaq.
/root/repos/dli_del/data/wav_split_gold/1189.wav	ăncyerkart nida mǣŋguh.
/root/repos/dli_del/data/wav_split_gold/188.wav	"Ti yada ǣsyatini', mimani' yamban' ŋob' tim' oni'."
/root/repos/dli_del/data/wav_split_gold/577.wav	"Tikar maqniwq ti tăd nyernyah tărcya ilamh piliq ponh yǎŋgowaq yeqǣ̌mnya mănʹ taryemh syertawǣmi,"
/root/repos/dli_del/data/wav_split_gold/1144.wav	"Maqniwq: «Sit toqǒla wǣnyekomh niw săpăŋguq,"
/root/repos/dli_del/data/wav_split_gold/1544.wav	ănyana ǣwaki?
/root/repos/dli_del/data/wav_split_gold/449.wav	«Sidya asăwamh odamcʹ.
/root/repos/dli_del/data/wav_split_gold/1502.wav	Tiki asăwar syaqnirinda unănda ădryoq ănyamna tănyamna ŋǣdălyortaki.
/root/repos/dli_del/data/wav_split_gold/1412.wav	"Nyeŋǣ mǣmda tyuquqkuh mǣda ŋăbtimda,"
/root/repos/dli_del/data/wav_split_gold/1702.wav	 Tyerkuda ңamgǣyq? 
/root/repos/dli_del/data/wav_split_gold/247.wav	"anyaŋid tamna ŋamdyo onaraŋgaŋgu"", "
/root/repos/dli_del/data/wav_split_gold/1187.wav	"todabcyaqyandoh ǣwanh tikanh puucyada pǣrŋada anih,"
/root/repos/dli_del/data/wav_split_gold/1381.wav	"tădaw maqniwq padraah anmh yarka nidawq irkādtaq,"
/root/repos/dli_del/data/wav_split_gold/616.wav	"«Tăryemh nibqnanda ilyeŋgōq anihni,"
/root/repos/dli_del/data/wav_split_gold/887.wav	"Tikanh ŋodh ŋabtarkada nisyǎda,"
/root/repos/dli_del/data/wav_split_gold/619.wav	"tiki nyer maqniwq, "
/root/repos/dli_del/data/wav_split_gold/1116.wav	ŋămgǣ ponh pǣrtada.
/root/repos/dli_del/data/wav_split_gold/994.wav	ǣbidya yar?
/root/repos/dli_del/data/wav_split_gold/1060.wav	«Yekarq». 
/root/repos/dli_del/data/wav_split_gold/515.wav	"Maqniwq tikar maqniwq ilyewanda yambanh maqniwq solotǣri talyebi, ti."
/root/repos/dli_del/data/wav_split_gold/719.wav	"adăndoh sidya ǣwanh siqiw ăbir,"
/root/repos/dli_del/data/wav_split_gold/382.wav	Tămna ǣqniwh tăkawaad(tikăăwaad).
/root/repos/dli_del/data/wav_split_gold/1525.wav	noy myadikocyah myunya.
/root/repos/dli_del/data/wav_split_gold/404.wav	"«Wǣy yabtkoyenh wadămi tǣwrain,"
/root/repos/dli_del/data/wav_split_gold/1677.wav	 Padibir? 
/root/repos/dli_del/data/wav_split_gold/1701.wav	  Manʹ putkomyeyh. 
/root/repos/dli_del/data/wav_split_gold/1368.wav	"ŋuliq ǣsyǎtiq tid, "
/root/repos/dli_del/data/wav_split_gold/319.wav	āslarăqninamh. 
/root/repos/dli_del/data/wav_split_gold/886.wav	«Ŋaatani syermi tuyesami sosoqmaădani lăŋgh nih ti pilih ponh maqniwq ilyewani yambanh ŋabtaŋguw».
/root/repos/dli_del/data/wav_split_gold/1378.wav	"Tădaw tiki ănanda ninya padraah ănanda ninya tadh taăbyad yendh anada, "
/root/repos/dli_del/data/wav_split_gold/297.wav	manyaq tiqnaq aqmaqawq. 
/root/repos/dli_del/data/wav_split_gold/1323.wav	syudbya wǣsăkoh nye nyunh maqniwq: «Mănʹ myakni andadmh».
/root/repos/dli_del/data/wav_split_gold/1220.wav	yesya wadămi ti tanyanyoq tyuriq tyuliba mǣta yesyǎ wădămi.
/root/repos/dli_del/data/wav_split_gold/298.wav	Ŋawnaawandoh 
/root/repos/dli_del/data/wav_split_gold/318.wav	Ŋămgǣmh tikāna pǣrtawaq?
/root/repos/dli_del/data/wav_split_gold/765.wav	"Yabtkoyenh, "
/root/repos/dli_del/data/wav_split_gold/1606.wav	Manʹ laanakow manqmaq “Lǣqmoqrakoq. 
/root/repos/dli_del/data/wav_split_gold/427.wav	syanh unath yadwăki ŋanih.
/root/repos/dli_del/data/wav_split_gold/753.wav	"«Tyedah mănʹ mǣdămd,"
/root/repos/dli_del/data/wav_split_gold/973.wav	"Ti ŋǣya, muncyalma."
/root/repos/dli_del/data/wav_split_gold/1014.wav	Nyenǣsyanda ŋodq maqniwq ŋarkaaw ŋǣwi yedda syanri ăbărtamh nyalranakǣ̄. 
/root/repos/dli_del/data/wav_split_gold/234.wav	"Nyerdye to""ma""rindo' amgǣd ŋǣsa "
/root/repos/dli_del/data/wav_split_gold/1042.wav	mănʹ ărqni tyedăŋguw».
/root/repos/dli_del/data/wav_split_gold/1515.wav	"Tiki noyah nyād myadmh syerta,"
/root/repos/dli_del/data/wav_split_gold/1054.wav	Muŋgoh pyay ăbir syudbyaq moncăŋgăqyaq tăsih yaah ith tyalkaădtasyetida.
/root/repos/dli_del/data/wav_split_gold/229.wav	"Ti"" lyekar"" ŋǣya"" mal' tikaana mǣcʹ. "
/root/repos/dli_del/data/wav_split_gold/1542.wav	" «Tiki noy ănyana aya, tiki noy ănyana ăya!»"
/root/repos/dli_del/data/wav_split_gold/596.wav	yalyah paryeŋoda maqnisawq:
/root/repos/dli_del/data/wav_split_gold/1665.wav	 Ңaaq. 
/root/repos/dli_del/data/wav_split_gold/1013.wav	"ŋămcidoh yaŋgaq tăryemh pyadaw, tăryemh."
/root/repos/dli_del/data/wav_split_gold/692.wav	tyaănyaŋi wārda ŋodʹrindoh ŋadibyerŋaq.
/root/repos/dli_del/data/wav_split_gold/1437.wav	ŋǣryoy sirăda aqă̌miqmaq.
/root/repos/dli_del/data/wav_split_gold/330.wav	uh mandadăma.
/root/repos/dli_del/data/wav_split_gold/962.wav	«ărqni anni tinimā ărqni ăbărtinimā ărqni ăbartin».
/root/repos/dli_del/data/wav_split_gold/1020.wav	"Măniyeǣwa nyenǣcyaq ŋǣwaq tikăana ŋuliq ŋokaq, tǣri tikaana ŋoniq."
/root/repos/dli_del/data/wav_split_gold/426.wav	"Pudăna myata ŋǣqniw,"
/root/repos/dli_del/data/wav_split_gold/1727.wav	 Manǣmanyepǣ  yutladasʹ. 
/root/repos/dli_del/data/wav_split_gold/1057.wav	nămdar?»
/root/repos/dli_del/data/wav_split_gold/772.wav	Puucyakui ti ărta ayuqniwq. 
/root/repos/dli_del/data/wav_split_gold/587.wav	nye yǎŋgoya.
/root/repos/dli_del/data/wav_split_gold/1456.wav	"nyabănda nyeh ănmh, "
/root/repos/dli_del/data/wav_split_gold/1374.wav	ŋămgǣda mălye yendăta yaqă̌wli. 
/root/repos/dli_del/data/wav_split_gold/1007.wav	mănʹ tyukini ărqni ăbărpăŋun».
/root/repos/dli_del/data/wav_split_gold/1174.wav	"Tăryemh sirŋā anih, "
/root/repos/dli_del/data/wav_split_gold/1438.wav	Sirănda aqămqmaad yǎtrih tăryemh nyaarq Tǣsʹdanda syenyey syanormiq myatoh ŋoqmaqaqtǣwih tyuku ăncyerq ŋaq ŋămgǣh? 
/root/repos/dli_del/data/wav_split_gold/984.wav	"ănni, ănni tiq ŋǣqniqimh»."
/root/repos/dli_del/data/wav_split_gold/307.wav	piliqkondoh ŋuliq tiki midoh ŋokaq. 
/root/repos/dli_del/data/wav_split_gold/1523.wav	ŋămgǣh myunya mǣdmh?
/root/repos/dli_del/data/wav_split_gold/147.wav	"ta tămna mantir""ni""ma tiki tina"". "
/root/repos/dli_del/data/wav_split_gold/221.wav	(Smye.)
/root/repos/dli_del/data/wav_split_gold/1397.wav	Tǣǣyuta nyana ǣsawa yonǣnye tida. 
/root/repos/dli_del/data/wav_split_gold/385.wav	"Nyenǣy myaq aniq,"
/root/repos/dli_del/data/wav_split_gold/508.wav	"Tad ǣwanda tǣwiwaq niwi syurambyuq anih maqniwq mi,"
/root/repos/dli_del/data/wav_split_gold/1264.wav	tyorsawǣyh myattyu.
/root/repos/dli_del/data/wav_split_gold/885.wav	tiki pasih nyu puucya maqniw:
/root/repos/dli_del/data/wav_split_gold/505.wav	Siirtyah ŋanih ida yadǣliq.
/root/repos/dli_del/data/wav_split_gold/378.wav	"ayeradh paryeŋoda ărta tyenyewa, maqniwq,"
/root/repos/dli_del/data/wav_split_gold/1649.wav	 Lǣqmoqrakow yedyokad taq! 
/root/repos/dli_del/data/wav_split_gold/1367.wav	"ŋuliq widărăŋaah, ŋuliq ŋilyekadyosyǎtiih,"
/root/repos/dli_del/data/wav_split_gold/1152.wav	"Maqniwq: «Sit toqǒla wǣnyekomh tibkaăna niw săpăŋguq, "
/root/repos/dli_del/data/wav_split_gold/216.wav	"pǣ""ya"" "
/root/repos/dli_del/data/wav_split_gold/239.wav	taryem' ti 
/root/repos/dli_del/data/wav_split_gold/146.wav	"Tăka ta""ălʹna madma mǣŋgu"","
/root/repos/dli_del/data/wav_split_gold/1624.wav	Tikaawaad sidya abiiyud ңǣdaraqnidimh.  
/root/repos/dli_del/data/wav_split_gold/173.wav	"ibya' tyempyeraturada tanya, "
/root/repos/dli_del/data/wav_split_gold/591.wav	"ŋanih taki nyaănda pyodaŋgu, ti – "
/root/repos/dli_del/data/wav_split_gold/1289.wav	"Yonǣdǣǣnanda yaah nyah lǣbtăna syudbyako tidǣh ŋǣŋgu,"
/root/repos/dli_del/data/wav_split_gold/523.wav	"Ti nyaanda ŋanih man-in, "
/root/repos/dli_del/data/wav_split_gold/486.wav	"Maqniwq pări yǎŋgoda tad nyernyah,"
/root/repos/dli_del/data/wav_split_gold/1712.wav	"Tiki nyada aniq tiki mi wandakomda nǣda aniq ǣwakuda syancyokuda malh ңam-yada, "
/root/repos/dli_del/data/wav_split_gold/1076.wav	"taykuna syanăkulwa asryoqyaqmi tăniwa,"
/root/repos/dli_del/data/wav_split_gold/500.wav	Ti maqniwq mănʹ woltawini.
/root/repos/dli_del/data/wav_split_gold/278.wav	"obamda abart ti, "
/root/repos/dli_del/data/wav_split_gold/100.wav	Mǣŋǣ tiki pih tyaah ŋobh mǣqyaq
/root/repos/dli_del/data/wav_split_gold/1201.wav	"«ǣy, adǣymh tadawa maqniwq sinyakurkaq anʹq maqniwq tyaananda [nyeracbortʃiwo]»."
/root/repos/dli_del/data/wav_split_gold/1005.wav	"pyadăr miq, "
/root/repos/dli_del/data/wav_split_gold/1686.wav	Posabitoңǣ pondaңǣ myerq tobaqңǣnaniңǣǣ ңǣni yudaңǣqgudamңǣ.
/root/repos/dli_del/data/wav_split_gold/111.wav	"maqnyu"": «ăbărcʹ nyu"" tara"", "
/root/repos/dli_del/data/wav_split_gold/435.wav	yesya arwăda maqniwq yaanda mantǣyq. 
/root/repos/dli_del/data/wav_split_gold/1091.wav	"tikaăna palli tănya ŋadʹbata,"
/root/repos/dli_del/data/wav_split_gold/647.wav	paryeŋodăanda maqniwq mi:
/root/repos/dli_del/data/wav_split_gold/1337.wav	mǣqŋadmh. 
/root/repos/dli_del/data/wav_split_gold/354.wav	Nyabtindh tǣwa tyuku padmh minye tămna syurămyubi.
/root/repos/dli_del/data/wav_split_gold/1741.wav	 Myadh nyo? 
/root/repos/dli_del/data/wav_split_gold/1181.wav	tǣwodăwǣmi ow».
/root/repos/dli_del/data/wav_split_gold/1123.wav	Syudbya wǣsako păŋgălmǣǣnanda manondqnidawh nyukcyamda.
/root/repos/dli_del/data/wav_split_gold/670.wav	"Siqiw ăbir ŋobh tănya una ŋǣwadiq,"
/root/repos/dli_del/data/wav_split_gold/1618.wav	mi anye ǣqmyaqad abiiyuta yewǣyh syancyoko ңamcyatida.  
/root/repos/dli_del/data/wav_split_gold/420.wav	"«Mănʹ taki yesya arwmh wadăbăda maqniwq, "
/root/repos/dli_del/data/wav_split_gold/1687.wav	" Wo, kakiye poʒyelaniya! "
/root/repos/dli_del/data/wav_split_gold/303.wav	"Tiki tiq, nyabiq tikiq "
/root/repos/dli_del/data/wav_split_gold/145.wav	Ŋǣya tika orpido'.
/root/repos/dli_del/data/wav_split_gold/1517.wav	"Nyabi ŋamdyorta nihmǣda tiki myadh myuh tah ayeda, "
/root/repos/dli_del/data/wav_split_gold/217.wav	"Ŋa tikar ŋawnanda tiki mancarawa yolʹcyaŋgana ŋuda masarpawancʹ tawi niw' ŋa"". "
/root/repos/dli_del/data/wav_split_gold/1225.wav	Wǣsăkoqyada ŋodh pinh ăya syudbya wǣsăkoqyand puucya ŋarŋociyeda nǣkălŋa.
/root/repos/dli_del/data/wav_split_gold/1568.wav	"Nyeңǣ tadawa yanh aqmiq aniq anya uyumgart myath wuni myattyuq aniq tyeǣ Wǣǣlya irinda myadh nyana ǣqniwq,"
/root/repos/dli_del/data/wav_split_gold/952.wav	Ŋaaq.
/root/repos/dli_del/data/wav_split_gold/1623.wav	“Ңuliq yabtkoyenh siqmi nyodih ayeq maqniwq Ңǣbt yambamh   tabcakǣdmh nyabakomi tabcakǣdmh.q 
/root/repos/dli_del/data/wav_split_gold/1729.wav	 Maqniwq sidya abi toңaancʹ yutnabcyandih pǣңǣ anadincʹ. 
/root/repos/dli_del/data/wav_split_gold/882.wav	nimda panǣnda nih syara ŋanih tyeǣ tohnyana ŋanih ăya.
/root/repos/dli_del/data/wav_split_gold/963.wav	[nyeracbortʃiwo].
/root/repos/dli_del/data/wav_split_gold/89.wav	ŋa tyukorkaăna nyaărq alʹmyer. 
/root/repos/dli_del/data/wav_split_gold/983.wav	«Mănʹ ărqni ilăŋgun –
/root/repos/dli_del/data/wav_split_gold/869.wav	ayerta ŋodh ti păkăltih ŋanih ith arbilih.
/root/repos/dli_del/data/wav_split_gold/1752.wav	 Manʹ obcow manqmaq puucyah piya alworta
/root/repos/dli_del/data/wav_split_gold/1529.wav	piinya anh irna towonda.
/root/repos/dli_del/data/wav_split_gold/982.wav	"«Ŋǣda, tăd ŋămganih!»"
/root/repos/dli_del/data/wav_split_gold/1036.wav	"păromlasyǎtida,"
/root/repos/dli_del/data/wav_split_gold/790.wav	"Puucya pinh aya,"
/root/repos/dli_del/data/wav_split_gold/1328.wav	Siqiw yurh uryoda.
/root/repos/dli_del/data/wav_split_gold/1064.wav	«alyamh nin adabasyatuh?»
/root/repos/dli_del/data/wav_split_gold/1283.wav	"«adăŋguqniqrawh maqniwq tyedah,"
/root/repos/dli_del/data/wav_split_gold/497.wav	"Maqniwq tiki wǣbărkar maqniwq ŋobkărt alyamh niq ayebyuq maqniwq tiki maqniwq,"
/root/repos/dli_del/data/wav_split_gold/219.wav	"ti puna mancayana"" pud "
/root/repos/dli_del/data/wav_split_gold/386.wav	"nyenǣy myadikocya aniq,"
/root/repos/dli_del/data/wav_split_gold/1501.wav	nyenyamda ti tyukuh tyukuh nyeŋǣ asăwaănda ti miqŋaduma anih.
/root/repos/dli_del/data/wav_split_gold/731.wav	Maqniwq: 
/root/repos/dli_del/data/wav_split_gold/1270.wav	Syudbya wǣsăko ŋanih tǣri muncyalma.
/root/repos/dli_del/data/wav_split_gold/124.wav	"Tăkaăd ubtaăna tăd yurkinaq, "
/root/repos/dli_del/data/wav_split_gold/274.wav	"tǣrinandoh aŋgawiq niqimh ŋaq, "
/root/repos/dli_del/data/wav_split_gold/645.wav	"ti, tyeǣ yanda yolʹcyandh. "
/root/repos/dli_del/data/wav_split_gold/468.wav	Maqniwq yaah tyuquqnyayuna maqmaniwq ŋămgǣrih toqǒla maqniwq yesyaqmaăna yuǔna yuŋgudima. 
/root/repos/dli_del/data/wav_split_gold/961.wav	«Tălʹqnyaku tuh!»
/root/repos/dli_del/data/wav_split_gold/1442.wav	"Waqnoqmitoh syerh waqniq tiq ŋǣdakiq,"
/root/repos/dli_del/data/wav_split_gold/1745.wav	 Manʹ obcow manqmaq sidya nyumda ңawlambadaanda lǣdǣrida ayowi
/root/repos/dli_del/data/wav_split_gold/1579.wav	nyenǣciyeni ңokawna yaңgumcʹ pǣңga pǣyadq aniq tikanda tyuku laanakoh ңamgǣq nyaamna wadasyalmadmh. 
/root/repos/dli_del/data/wav_split_gold/1561.wav	Ti pilibtariq ti anaqmadih ti.
/root/repos/dli_del/data/wav_split_gold/286.wav	ti tǣǣqnaq tǣǣqnaqta tikaana awi.
/root/repos/dli_del/data/wav_split_gold/29.wav	Nisyani wǣsakoh ŋǣsiit tikaăd mănʹ măncăralluwh.
/root/repos/dli_del/data/wav_split_gold/1423.wav	orkih yay niwi ŋǣbat syurpyuq».
/root/repos/dli_del/data/wav_split_gold/1467.wav	"Yekar maq(niqd)amh tinik yekar ŋămgǣ ŋǣdaki, ti."
/root/repos/dli_del/data/wav_split_gold/642.wav	"Ti solotǣy minărtar ŋanih inumdqniwh,"
/root/repos/dli_del/data/wav_split_gold/399.wav	Maqniwq ancyerh ŋǣdaki?
/root/repos/dli_del/data/wav_split_gold/383.wav	  Syanrinda ponh mǣbq mimbqnanda ŋodh nyerănda nyana ŋobh myaq. 
/root/repos/dli_del/data/wav_split_gold/1028.wav	Tuh ǣwăna yekar ŋămgǣrkaawmh mănǣqŋaq tuda pinyaŋi ǣwuwna.
/root/repos/dli_del/data/wav_split_gold/1405.wav	"ilye tobqni nyadănd oŋguwăwa, "
/root/repos/dli_del/data/wav_split_gold/1563.wav	Ңobh ңǣsiqңaq tiki nyenǣciyed pyeryenitoh nyah tikitoh yambanh.
/root/repos/dli_del/data/wav_split_gold/262.wav	ŋobkart nyenǣcʹh tikana yaŋgodasʹ. 
/root/repos/dli_del/data/wav_split_gold/1277.wav	"Syudbya wǣsakoh nye nyu maqniwq: «Tyedah wunin andāh maqniwq tyedah irimd adăŋguqniqnawh,"
/root/repos/dli_del/data/wav_split_gold/1450.wav	 tikād tikaad oda. 
/root/repos/dli_del/data/wav_split_gold/646.wav	"Paryeŋodăanda tǣwih yesya arwmh paryeŋodănda wadăbădamh,"
/root/repos/dli_del/data/wav_split_gold/755.wav	"tyaănyaŋi maqniwq silpăwi muŋgonaq tiqnyoq,"
/root/repos/dli_del/data/wav_split_gold/764.wav	Tiki muŋgoh maqniwq silămnyandoh ŋǣbh ilyewaq.
/root/repos/dli_del/data/wav_split_gold/1180.wav	"«Tădaw ādmh,"
/root/repos/dli_del/data/wav_split_gold/579.wav	"Ti, maqniwq:"
/root/repos/dli_del/data/wav_split_gold/1073.wav	"Muŋgoh pyay ăbi mannaqmaq: «Mănʹ myakni ayadmh, "
/root/repos/dli_del/data/wav_split_gold/1539.wav	"tiki noy yoormh tad yoqmăda yaananda,"
/root/repos/dli_del/data/wav_split_gold/1387.wav	ănartă̌mi anah».
/root/repos/dli_del/data/wav_split_gold/899.wav	"Muŋgoq pyay ăbi ŋanih saalta ŋanih loolba tuta,"
/root/repos/dli_del/data/wav_split_gold/1137.wav	"ǣ̄ye, ti tikar maqniwq: "
/root/repos/dli_del/data/wav_split_gold/1743.wav	 Aa nyoh padqmaq. 
/root/repos/dli_del/data/wav_split_gold/1455.wav	"Tăd-i nyabănda,"
/root/repos/dli_del/data/wav_split_gold/268.wav	tarcya mancayam pǣrmani yeqǣmnya.
/root/repos/dli_del/data/wav_split_gold/644.wav	"Ŋuliq ŋokăndoh inomdaq,"
/root/repos/dli_del/data/wav_split_gold/1556.wav	Ңǣdalyowanondih nyaantih laanawanondih mamonondih tyedah nyabi mamononda ma tyedah mǣǣnih tyuku yaah nyencawǣǣna nyertyeңgoonih. 
/root/repos/dli_del/data/wav_split_gold/1242.wav	Syudbya wǣsăko tǣri muncyalma. 
/root/repos/dli_del/data/wav_split_gold/824.wav	"adăda maqniwq, "
/root/repos/dli_del/data/wav_split_gold/1087.wav	"Syaarih unat yadbăti ŋodh ŋulih yalǣma,"
/root/repos/dli_del/data/wav_split_gold/1663.wav	 Da. Da wyedʹ.
/root/repos/dli_del/data/wav_split_gold/470.wav	"Tiki ilăndih mǣtăandih tǣtyermi nyenǣcyangh maqniwq yah nimnya maqniwq maŋgă̌bădaat,"
/root/repos/dli_del/data/wav_split_gold/536.wav	"myadmh ōdǣ̄mh,"
/root/repos/dli_del/data/wav_split_gold/1121.wav	sit manoqmi ŋaaq». 
/root/repos/dli_del/data/wav_split_gold/657.wav	Nyero yaakoh ǣwana siqiw ăbi. 
/root/repos/dli_del/data/wav_split_gold/9.wav	"Maraŋga ŋǣya, "
/root/repos/dli_del/data/wav_split_gold/1009.wav	"Syudbya wǣsăko masʹ tumda pyaq yonǣwna nidawh pyataq anih, "
/root/repos/dli_del/data/wav_split_gold/1291.wav	"tidǣh tidǣ̄ŋgăna syudbyako maqniwh mi,"
/root/repos/dli_del/data/wav_split_gold/526.wav	"Ti mănʹ tikar,"
/root/repos/dli_del/data/wav_split_gold/1632.wav	maqniwq: “Sit adaңgudmh.q 
/root/repos/dli_del/data/wav_split_gold/810.wav	waqăwănda mǣnăkǣdā.
/root/repos/dli_del/data/wav_split_gold/1199.wav	"«Tyaănanda nyenǣcʹ ŋǣbta onradwa, nyenǣciye [nyeracbortʃiwo], "
/root/repos/dli_del/data/wav_split_gold/1169.wav	Tasih tǣri lyabtar-yq. 
/root/repos/dli_del/data/wav_split_gold/251.wav	"ibyaart yeǣra, "
/root/repos/dli_del/data/wav_split_gold/931.wav	taminda ăya.
/root/repos/dli_del/data/wav_split_gold/1034.wav	"«Yedmih ŋămgămih,"
/root/repos/dli_del/data/wav_split_gold/555.wav	tad nyernyahtărcya nyenǣcʹh yaŋgoya.
/root/repos/dli_del/data/wav_split_gold/866.wav	salabaq ŋanih animyaq. 
/root/repos/dli_del/data/wav_split_gold/754.wav	"tyedah waaltamd maqnidămh tyedah mǣŋgudmh, "
/root/repos/dli_del/data/wav_split_gold/1410.wav	sidya tyusipoyh nyani tǣri sirŋa tăryemh ŋadʹbăta».
/root/repos/dli_del/data/wav_split_gold/459.wav	"«Ŋa, tikăāyud?"
/root/repos/dli_del/data/wav_split_gold/461.wav	Ti.
/root/repos/dli_del/data/wav_split_gold/949.wav	tonda tyaah ăbărpa pyayda.
/root/repos/dli_del/data/wav_split_gold/1689.wav	 Worona oroʃaya. aa.
/root/repos/dli_del/data/wav_split_gold/1698.wav	 Putkodanih? 
/root/repos/dli_del/data/wav_split_gold/531.wav	 Tădawa ti.
/root/repos/dli_del/data/wav_split_gold/129.wav	Ŋodʹbyaqnaq tiki tikih pud ti ŋǣdalyo tayh raciyamh osăya ǣqnihwamh. 
/root/repos/dli_del/data/wav_split_gold/108.wav	"wot, ti,"
/root/repos/dli_del/data/wav_split_gold/1184.wav	"winyalsipoyh,"
/root/repos/dli_del/data/wav_split_gold/793.wav	"Nyaŋǣdya pinda yamban,"
/root/repos/dli_del/data/wav_split_gold/1569.wav	anda nyana. 
/root/repos/dli_del/data/wav_split_gold/1017.wav	"Syudbya mannaqmaq: «Taykuy yesya paŋgqyaq tinyoq,"
/root/repos/dli_del/data/wav_split_gold/1210.wav	soo myata tyaănyaŋi ǣw.
/root/repos/dli_del/data/wav_split_gold/1404.wav	"«ănkoyemi lǣtămbabcur,"
/root/repos/dli_del/data/wav_split_gold/1673.wav	Nyodoh pyaata tyoritadmh kaawǣy.
/root/repos/dli_del/data/wav_split_gold/1248.wav	"ăncyerq ŋǣda nyemar maqniwq tyuku,"
/root/repos/dli_del/data/wav_split_gold/604.wav	"Yǎŋgō, tămna todalambidawa ŋamgǣrida."
/root/repos/dli_del/data/wav_split_gold/1621.wav	Lǣqmoqrakomh nyaqmaqdih maqniqimh tyedah yewǣynih syancyoko ңawortan tin ңǣsyatwinanyoq manih sit adaңgunih. 
/root/repos/dli_del/data/wav_split_gold/763.wav	Tiki muŋgq maqniwq yǎtrih mănǣsărănh usuwǣy yalyah. 
/root/repos/dli_del/data/wav_split_gold/846.wav	tad tuta pǣwsyumyah nyana adăda tămna yusyedaŋō.
/root/repos/dli_del/data/wav_split_gold/488.wav	Mandānăwa.
/root/repos/dli_del/data/wav_split_gold/1670.wav	 yeye.
/root/repos/dli_del/data/wav_split_gold/491.wav	"maqniwq, wǣbărkaq yah nih,"
/root/repos/dli_del/data/wav_split_gold/513.wav	Tikaqyar maqniwq talyey nyenǣcʹh.
/root/repos/dli_del/data/wav_split_gold/250.wav	tyedah ibya punryoda. 
/root/repos/dli_del/data/wav_split_gold/120.wav	Tăka ănih (ŋăni') myakăd wadawi ŋawkakoqyawa tanyawasʹ.
/root/repos/dli_del/data/wav_split_gold/258.wav	anyaawanaq. 
/root/repos/dli_del/data/wav_split_gold/186.wav	"Tyukoona ŋob' syudbya, "
/root/repos/dli_del/data/wav_split_gold/1082.wav	ubta?» 
/root/repos/dli_del/data/wav_split_gold/1192.wav	«(Ŋ)Amgǣ to?»
/root/repos/dli_del/data/wav_split_gold/909.wav	«Wadyet!» 
/root/repos/dli_del/data/wav_split_gold/249.wav	unaaw ŋanih ŋobtaryemh yeryemda ŋanih pyaraŋgudq.
/root/repos/dli_del/data/wav_split_gold/1361.wav	"Ti tikănda asăwada tăryemh syurpi mǣkocyadămda,"
/root/repos/dli_del/data/wav_split_gold/1452.wav	nyabănda tucyah myumnya ulcotoliq. 
/root/repos/dli_del/data/wav_split_gold/833.wav	"Muŋgoh pyay ăbin ŋa, maqniwq."
/root/repos/dli_del/data/wav_split_gold/1614.wav	sidya abir towonodih aniq Lǣqmoqrakor makodah siwnya nyalkara.
/root/repos/dli_del/data/wav_split_gold/691.wav	"ŋarka to,"
/root/repos/dli_del/data/wav_split_gold/1725.wav	  Yah ңilh podasʹ.  
/root/repos/dli_del/data/wav_split_gold/1008.wav	adăwida ŋǣqniqimh.
/root/repos/dli_del/data/wav_split_gold/1048.wav	«Tyedah yaani lăŋgana ŋamdyodadmh ŋaat ŋamdyolawamih ilyewah yambanh».
/root/repos/dli_del/data/wav_split_gold/944.wav	"Tăd yech mǣyda anih,"
/root/repos/dli_del/data/wav_split_gold/1572.wav	"Ti, tiki myat tad myarwanda yesʹ, "
/root/repos/dli_del/data/wav_split_gold/1453.wav	"Tuh yesyamh o,"
/root/repos/dli_del/data/wav_split_gold/834.wav	"Ti makănda mǣdawa,"
/root/repos/dli_del/data/wav_split_gold/849.wav	Muŋgoq pyay abi –
/root/repos/dli_del/data/wav_split_gold/1039.wav	wǣsakoq maqniwq.
/root/repos/dli_del/data/wav_split_gold/770.wav	"tămna niw amyedaq,"
/root/repos/dli_del/data/wav_split_gold/1492.wav	"«Tyedă ma nyedwaq mǣbqnaq tara,"
/root/repos/dli_del/data/wav_split_gold/843.wav	"Muŋgoq pyay abi adăkoyenda tumh pyata ayesyatida ubtaana,"
/root/repos/dli_del/data/wav_split_gold/1650.wav	 Yedyokaabini udq tawnyan  
/root/repos/dli_del/data/wav_split_gold/26.wav	 Tăka?]
/root/repos/dli_del/data/wav_split_gold/396.wav	"Maqniwq ti,"
/root/repos/dli_del/data/wav_split_gold/663.wav	ŋulih  puucya.
/root/repos/dli_del/data/wav_split_gold/1440.wav	"Syenyah ti sita anaqcyaqnyoq tiki myadǣǣdandoh niwidq yamdaq,"
/root/repos/dli_del/data/wav_split_gold/244.wav	"taŋok"" ti"", syanri ŋǣsi"" ti"" "
/root/repos/dli_del/data/wav_split_gold/1261.wav	tiki wǣsakor tyorkosăwǣyh nidawh nǣkălah puucyamda.
/root/repos/dli_del/data/wav_split_gold/1417.wav	"ănh mǣnh ancăth tucʹ ŋurkăda(wirkăda) nyenǣciyeq pomna,"
/root/repos/dli_del/data/wav_split_gold/974.wav	"Siqiw ăbărtamda ti ŋopoy muŋgh pyaana niqimh ŋaq nida ăbărq, "
/root/repos/dli_del/data/wav_split_gold/532.wav	Tǣwowăndid mălyeyd?
/root/repos/dli_del/data/wav_split_gold/1731.wav	 obcokoq. 
/root/repos/dli_del/data/wav_split_gold/1268.wav	pih ŋanih tyeda ăncyerh myadh myumnya yadǣlina?»
/root/repos/dli_del/data/wav_split_gold/1471.wav	Syanrinda unh yadbata ŋodh piliq widărăŋo tădawa.
/root/repos/dli_del/data/wav_split_gold/1516.wav	myadikocyamh.
/root/repos/dli_del/data/wav_split_gold/1744.wav	" nyoh padqmaq, ңaaq. "
/root/repos/dli_del/data/wav_split_gold/914.wav	"măncyaw aŋguqnidămah tyedah ti tadaw,"
/root/repos/dli_del/data/wav_split_gold/1079.wav	"mănʹ myat tyenyewaw, "
/root/repos/dli_del/data/wav_split_gold/483.wav	towănda alyamh ma nyernyād maqniwq mi pidyebidoh.
/root/repos/dli_del/data/wav_split_gold/1508.wav	Noyh myunya ŋanih ŋămgǣ pǣbti?
/root/repos/dli_del/data/wav_split_gold/582.wav	"tămna tyeǣ nyamda poyomdaŋguwa,"
/root/repos/dli_del/data/wav_split_gold/1162.wav	"Tăryemh sirŋa maqniwq mi toh tyaah tăryemh sirŋa anih,"
/root/repos/dli_del/data/wav_split_gold/614.wav	tăryemh ilyeŋgobqnanda – maqniwq –
/root/repos/dli_del/data/wav_split_gold/477.wav	yawh măraăna.
/root/repos/dli_del/data/wav_split_gold/1735.wav	" Niңǣ, pǣ yedh ңamdyoqmyaq. "
/root/repos/dli_del/data/wav_split_gold/581.wav	"tămna tyeǣ nyanda asăwanh onăŋguqmaq,"
/root/repos/dli_del/data/wav_split_gold/1642.wav	yesya yarakomi. 
/root/repos/dli_del/data/wav_split_gold/1613.wav	"Lǣqmoqrakor yewǣyh syancyoko ңam-yada, "
/root/repos/dli_del/data/wav_split_gold/78.wav	Nyaărq tǣmih myaknih tǣwqmaqriidanih pih minandoh awiq. 
/root/repos/dli_del/data/wav_split_gold/132.wav	ti mălye syanaw 
/root/repos/dli_del/data/wav_split_gold/1734.wav	 Tiki tiq tobaq. 
/root/repos/dli_del/data/wav_split_gold/269.wav	anya tyeda tikid amgǣǣrtaad yeǣraq.
/root/repos/dli_del/data/wav_split_gold/1565.wav	pida ani tiki ңaat asawanda arta nyerdanda asawanda anh wǣynyah tiyq.
/root/repos/dli_del/data/wav_split_gold/1372.wav	"mălye yaah salth mălye măriŋǣ ǣwi anih,"
/root/repos/dli_del/data/wav_split_gold/726.wav	"Mambat madyuq(manyoq) tiki yaana,"
/root/repos/dli_del/data/wav_split_gold/86.wav	ăcyerq (ăncyerq) ŋǣsa?
/root/repos/dli_del/data/wav_split_gold/1577.wav	Ti tǣri myattyu. 
/root/repos/dli_del/data/wav_split_gold/729.wav	adamdoh mǣmbdaandoh.
/root/repos/dli_del/data/wav_split_gold/1200.wav	sinyakuh ǣyawa».
/root/repos/dli_del/data/wav_split_gold/1379.wav	ănsăwǣyq.
/root/repos/dli_del/data/wav_split_gold/997.wav	"Nyero yaah lăŋgh ninya nyenǣsyanda ŋodh mǣda tănyawi,"
/root/repos/dli_del/data/wav_split_gold/1617.wav	abiiyuta poyoq... 
/root/repos/dli_del/data/wav_split_gold/883.wav	"Yedkocyamda, "
/root/repos/dli_del/data/wav_split_gold/178.wav	"ŋani ŋǣsina"" tyer"" tyuku mǣǣna ai"" "
/root/repos/dli_del/data/wav_split_gold/745.wav	 «Tă siqmi ŋǣdărah nini ayaq wacʹ»
/root/repos/dli_del/data/wav_split_gold/759.wav	tyedah mǣynacʹqnyoq yalyah».
/root/repos/dli_del/data/wav_split_gold/1599.wav	Pirda ңǣңgo. 
/root/repos/dli_del/data/wav_split_gold/168.wav	Ti puucyada taminda oy' nina mǣ. 
/root/repos/dli_del/data/wav_split_gold/1139.wav	ti tikaăna mǣbqni tăryemh siqmi mǣŋgosan?»
/root/repos/dli_del/data/wav_split_gold/1678.wav	 Padibiw! 
/root/repos/dli_del/data/wav_split_gold/1246.wav	"puucyamda ŋuliq tǣdorpăwanonda, maqniwq:"
/root/repos/dli_del/data/wav_split_gold/1667.wav	 pro woronu.
/root/repos/dli_del/data/wav_split_gold/521.wav	solotǣri mǣqŋaq yesyadanda.
/root/repos/dli_del/data/wav_split_gold/457.wav	"ăncyerkărth ŋanondih myud maqniwq oŋgărā yaqămadih, yaqămamih, maqniwq, yaqămamih, maqniwq. "
/root/repos/dli_del/data/wav_split_gold/572.wav	"tiki yaănda aŋgu,"
/root/repos/dli_del/data/wav_split_gold/1490.wav	"asăwanda nyana ăya anih, "
/root/repos/dli_del/data/wav_split_gold/782.wav	Iinani mancyetidmh:
/root/repos/dli_del/data/wav_split_gold/1207.wav	"Piyada maqniwq nyaŋǣdya maqniwq yumbărad syedah ŋar,"
/root/repos/dli_del/data/wav_split_gold/355.wav	Tadawa.
/root/repos/dli_del/data/wav_split_gold/1142.wav	«Tyedah mănʹ sit manoŋgadmh tikaăna».
/root/repos/dli_del/data/wav_split_gold/873.wav	"punaāw itămd oqidămcʹ,"
/root/repos/dli_del/data/wav_split_gold/851.wav	adăanda mannaqmaq:
/root/repos/dli_del/data/wav_split_gold/1202.wav	Maqniwq tikaawaana tikimh nyunda watormamh namdăăwa maqniwq taralkaya maqniw tyuulmăndamih niwŋaq sidya sidyaat taral-yaq tad nǣkălmandih ŋob taqlyooy to.
/root/repos/dli_del/data/wav_split_gold/552.wav	nyuda sǣrdaăna adabăŋguda.
/root/repos/dli_del/data/wav_split_gold/1356.wav	maqniwq:
/root/repos/dli_del/data/wav_split_gold/197.wav	"pili"" pon' ti yada yadǣrcʹ "
/root/repos/dli_del/data/wav_split_gold/412.wav	tuda tǣri ăŋărŋa.
/root/repos/dli_del/data/wav_split_gold/236.wav	"amgǣǣwadda tatawa""». "
/root/repos/dli_del/data/wav_split_gold/1197.wav	Puucyada maqniwq:
/root/repos/dli_del/data/wav_split_gold/255.wav	"ti lusariq, ti tiq lyekarq."
/root/repos/dli_del/data/wav_split_gold/141.wav	"Tika tǣwma""riidando' ŋobtiki"" ti"" nyenǣcyandaryew',"
/root/repos/dli_del/data/wav_split_gold/989.wav	"syudbyew tălyah, "
/root/repos/dli_del/data/wav_split_gold/1411.wav	Wadăwa sinyana miqnimh mǣsyǎtinyoq tănyana măndalaŋguq inqniqimhtǣtamboyaqna.
/root/repos/dli_del/data/wav_split_gold/1385.wav	Maqniwq: 
/root/repos/dli_del/data/wav_split_gold/905.wav	"ŋulih yabtkoyenh wadyetăwa,"
/root/repos/dli_del/data/wav_split_gold/901.wav	tircumba turŋa. 
/root/repos/dli_del/data/wav_split_gold/624.wav	tiki pǣwdyumd.
/root/repos/dli_del/data/wav_split_gold/475.wav	tărcya ŋǣǣ̄wabtih tiki ŋănondih nih tah aŋguuh.
/root/repos/dli_del/data/wav_split_gold/1326.wav	"ănoh tǣtā anih,"
/root/repos/dli_del/data/wav_split_gold/495.wav	"syaŋok wǣbărka ŋǣdaki aniq, "
/root/repos/dli_del/data/wav_split_gold/233.wav	"nyana"" ma""ni""im' tyuku""."
/root/repos/dli_del/data/wav_split_gold/981.wav	 ǣbidya yaănani aŋoronda ŋămgănima!
/root/repos/dli_del/data/wav_split_gold/180.wav	"Manʹ tadtikaad ŋob' nyami, "
/root/repos/dli_del/data/wav_split_gold/525.wav	Ŋamgǣh myană̌mbowna ilyeya.
/root/repos/dli_del/data/wav_split_gold/874.wav	tyedarih ith ŋulih ărwadmh itmih osqmaq».
/root/repos/dli_del/data/wav_split_gold/428.wav	uh Siirtyar ayerh paryeŋodanh laănăko miqniqimh
/root/repos/dli_del/data/wav_split_gold/1105.wav	"ti nyerărkah tiki mimh , "
/root/repos/dli_del/data/wav_split_gold/676.wav	«Tarsih ith ărwawoni».
/root/repos/dli_del/data/wav_split_gold/1108.wav	tikimh tyunda siriwna pǣrŋada. 
/root/repos/dli_del/data/wav_split_gold/976.wav	"«Nyukcya,"
/root/repos/dli_del/data/wav_split_gold/638.wav	"Ti, tunda ǣwad nye tǣri tyuquq sănăyeq,"
/root/repos/dli_del/data/wav_split_gold/1424.wav	"Tikād ŋanih tyuquq mǣda mǣmda myuykonda pyelyah pita, "
/root/repos/dli_del/data/wav_split_gold/896.wav	tyuku ŋămgǣ?»
/root/repos/dli_del/data/wav_split_gold/172.wav	"tiki"" nyenǣciye"" tyempyeraturi onrambi"", orpi. "
/root/repos/dli_del/data/wav_split_gold/1040.wav	"Maqniwq: «Syaarih ti anyeda ăbărti adabăt tikăana yedamd ărt tyedibăir, "
/root/repos/dli_del/data/wav_split_gold/545.wav	Tikar maqniwq ilyewanda yambanh maqniwq 
/root/repos/dli_del/data/wav_split_gold/485.wav	Pări tăryemh ŋobtiki ŋǣbta ni taraq.
/root/repos/dli_del/data/wav_split_gold/235.wav	"ma""ni""im': «Myadoda"" tyeda' paradaŋguna"","
/root/repos/dli_del/data/wav_split_gold/443.wav	Siirtya maqniwq:
/root/repos/dli_del/data/wav_split_gold/1130.wav	"«Watomi yuq tibya mi,"
/root/repos/dli_del/data/wav_split_gold/903.wav	Tiki Muŋgoq pyay ăbi tiki adănda panota nih ŋamdălcʹ tikăana nidawh pyah.
/root/repos/dli_del/data/wav_split_gold/177.wav	"Tikad ti mi ta""alʹnya sidna mǣ""maadando' ti,"
/root/repos/dli_del/data/wav_split_gold/403.wav	«ayerăd paryeŋodanh miŋadmh».
/root/repos/dli_del/data/wav_split_gold/1639.wav	adakaabini yesyaq yakrodǣqǣmh. 
/root/repos/dli_del/data/wav_split_gold/393.wav	"Ŋaaq, tiki tukocyaănda."
/root/repos/dli_del/data/wav_split_gold/697.wav	«Ŋanih ŋobh siddaq mănǣqdămnyowh maqniwq tǣri ădryaŋodh».
/root/repos/dli_del/data/wav_split_gold/1221.wav	"Yesya wădăana maqniwq mǣǣnda tyuku,"
/root/repos/dli_del/data/wav_split_gold/65.wav	"Mǣ ti tănya' ăyanih, ŋuliq yadyembi."
/root/repos/dli_del/data/wav_split_gold/574.wav	«Tiki yaănda – maqniwq –
/root/repos/dli_del/data/wav_split_gold/595.wav	"nyaanda man-in ,"
/root/repos/dli_del/data/wav_split_gold/635.wav	mănʹtan ŋodh maqniwq:
/root/repos/dli_del/data/wav_split_gold/12.wav	Tănyana nyaărq ŋǣsisʹ. 
/root/repos/dli_del/data/wav_split_gold/431.wav	"Maqniwq yesya arw, maqniwq,"
/root/repos/dli_del/data/wav_split_gold/674.wav	ayerta tăŋgowna ŋǣǣwa ŋǣryoy niwŋaq. 
/root/repos/dli_del/data/wav_split_gold/923.wav	"nyermya toni tyaănyaŋi ǣwăna maqniwq ti,"
/root/repos/dli_del/data/wav_split_gold/109.wav	tiqnaq lyekarăkoqyaq praktikant ămgǣmh (ŋămgǣmh) tyenyewa?!
/root/repos/dli_del/data/wav_split_gold/0.wav	"«Myaryosiw tina (Myaryosiw ti), "
/root/repos/dli_del/data/wav_split_gold/123.wav	tih aqmah ǣwănh mow.
/root/repos/dli_del/data/wav_split_gold/1190.wav	Mănʹ yǎnămbowna myattyudāmh anih myatoh anyerq myuq. 
/root/repos/dli_del/data/wav_split_gold/1177.wav	nyambor myattyu.
/root/repos/dli_del/data/wav_split_gold/55.wav	"tah ŋănih taki nyenǣcyamh ŋǣdătamba pyasyǎti, "
/root/repos/dli_del/data/wav_split_gold/1298.wav	"yaanh lǣbtăna syudbyako tidǣh tănyawi,"
/root/repos/dli_del/data/wav_split_gold/918.wav	nikid ŋǣwi ŋǣbtumh –
/root/repos/dli_del/data/wav_split_gold/626.wav	"tiki yaăna tănya ai,"
/root/repos/dli_del/data/wav_split_gold/1429.wav	"Nyabi wari myakăd nidawh moyopyuh,"
/root/repos/dli_del/data/wav_split_gold/1721.wav	 Tiki pǣdarar maqniwq ǣǣh tu paradadasʹ. 
/root/repos/dli_del/data/wav_split_gold/1309.wav	"ora lukqyaq ŋamdyoda,"
/root/repos/dli_del/data/wav_split_gold/164.wav	"Tyeda' taykuy ŋobto' Karaulăd ŋǣda,"
/root/repos/dli_del/data/wav_split_gold/1292.wav	"miq ŋamdyodaq tyuku tikiqyaq tiki ŋămgǣ pălka,"
/root/repos/dli_del/data/wav_split_gold/1266.wav	Muŋgoh pyay ăbi maqniwq: 
/root/repos/dli_del/data/wav_split_gold/991.wav	«Mănʹ anyesǣyăbini ărqni ilăŋgun».
/root/repos/dli_del/data/wav_split_gold/1041.wav	mănʹ tyedah mănʹ mǣwăndami ŋǣqniwh –
/root/repos/dli_del/data/wav_split_gold/1178.wav	Puucyada tănyawi.
/root/repos/dli_del/data/wav_split_gold/867.wav	"Nyewi irinata tiki muŋgoh yesyaq,"
/root/repos/dli_del/data/wav_split_gold/567.wav	ŋuliq părădawǣda –
/root/repos/dli_del/data/wav_split_gold/231.wav	Nyerdye tamna 
/root/repos/dli_del/data/wav_split_gold/1571.wav	anda tad iprawanda  tiki anand myunya nyaңǣdya myaq ңǣwi.
/root/repos/dli_del/data/wav_split_gold/1118.wav	"«Tădaw, nyukcya,"
/root/repos/dli_del/data/wav_split_gold/1263.wav	"Sooh sidya yawna tăryemh wǣsoda mănrircʹ ǣwănondōh,"
/root/repos/dli_del/data/wav_split_gold/293.wav	] Tiq alʹmyer. 
/root/repos/dli_del/data/wav_split_gold/110.wav	"Brigadir maqnyu"", ămgǣ (ŋămgǣ),"
/root/repos/dli_del/data/wav_split_gold/603.wav	Tiki nyeh myaqămna tosʹ niwh taraq.
/root/repos/dli_del/data/wav_split_gold/715.wav	tyukuhtoqǒla maqniwq tyuku tǣ tuyesh myuh syāărth(syaaărth) taryemh nisʹ loombyuq iq 
/root/repos/dli_del/data/wav_split_gold/1215.wav	tăryemh incyelye anih wǣsăkoqyaq ăsăbărmanonda: 
/root/repos/dli_del/data/wav_split_gold/271.wav	Ti ti tyuku mǣr tanyah nyaandoh wuni tǣworq. 
/root/repos/dli_del/data/wav_split_gold/643.wav	maqniwq: «Syanh tărcyadmh nidmh ŋǣŋguh».
/root/repos/dli_del/data/wav_split_gold/1558.wav	"Mi uyumih nyamda nyertyeda maqniwq tikiyumih nyemda anaңguda Noy mărădyaŋg mamononda nyertyeǣrtabqnand mamononda ңǣqniwq mi niw tath maqniwq mi,"
/root/repos/dli_del/data/wav_split_gold/1171.wav	"Ŋani siqiw yalyah ŋanih oni anih, maqniwq: "
/root/repos/dli_del/data/wav_split_gold/704.wav	Tiki yedăr ŋămgǣda ădkǣya.
/root/repos/dli_del/data/wav_split_gold/133.wav	ti aq tiki. 
/root/repos/dli_del/data/wav_split_gold/1483.wav	"yekar onǣyq, "
/root/repos/dli_del/data/wav_split_gold/709.wav	Tiki nyerh idartawi ăbid tǣri ŋamdidq.
/root/repos/dli_del/data/wav_split_gold/1247.wav	"«Ŋopoy asăwa nyumih mayedadamnyoq,"
/root/repos/dli_del/data/wav_split_gold/291.wav	] anyana? 
/root/repos/dli_del/data/wav_split_gold/161.wav	"Tăd tikaawaăd maddye""nidum' mal'. "
/root/repos/dli_del/data/wav_split_gold/828.wav	yarta ŋăcyekimh.
/root/repos/dli_del/data/wav_split_gold/672.wav	mirwodoh. 
/root/repos/dli_del/data/wav_split_gold/287.wav	] Tyuku tiq alʹmyer anyana ŋa? 
/root/repos/dli_del/data/wav_split_gold/658.wav	Siqiw ăbih adădoh tănya.
/root/repos/dli_del/data/wav_split_gold/273.wav	ti tyuku tyuku abcyaŋgana ti 
/root/repos/dli_del/data/wav_split_gold/1646.wav	 Murtikaawami udq tawnaw tah myaqni ңuq. 
/root/repos/dli_del/data/wav_split_gold/688.wav	"Nyermya toǒnda ăya anih,"
/root/repos/dli_del/data/wav_split_gold/1626.wav	“Syoncyand ayuta wadamh mǣtadmh. 
/root/repos/dli_del/data/wav_split_gold/171.wav	"asawayu"" tʃas' yolʹcyand' "
/root/repos/dli_del/data/wav_split_gold/502.wav	"tarcya ŋǣŋgobqnandoh tăd nyernyah wǣbărkaq,"
/root/repos/dli_del/data/wav_split_gold/117.wav	"ăbărŋawaq, tăka puna"
/root/repos/dli_del/data/wav_split_gold/1120.wav	"«Tyedah sit mi, "
/root/repos/dli_del/data/wav_split_gold/331.wav	"Syaări tikowna yadbăta,"
/root/repos/dli_del/data/wav_split_gold/908.wav	 tuyes loombăŋgu  yedǣy tǣwrawi anyuy iq? »
/root/repos/dli_del/data/wav_split_gold/544.wav	Tiki ŋanih mănʹ taryem syertawǣmi.
/root/repos/dli_del/data/wav_split_gold/156.wav	"tyeǣ tiki yamda""ma""wa"" myadi' nyana "
/root/repos/dli_del/data/wav_split_gold/425.wav	Yadǣr-yanda syurtyarh ti ŋǣqniwh.
/root/repos/dli_del/data/wav_split_gold/213.wav	"Ti"" (tiki?) tarcya piryembiwa"". "
/root/repos/dli_del/data/wav_split_gold/368.wav	"Maqnidă̌mh,"
/root/repos/dli_del/data/wav_split_gold/1384.wav	Sidyah sǣrh puh nidawh wǣtah.
/root/repos/dli_del/data/wav_split_gold/1320.wav	"Tiki ŋinănda muŋgsăwǣyh irinda ărta ŋinda ŋǣqnisawq tăryemh anaqnidawh,"
/root/repos/dli_del/data/wav_split_gold/13.wav	I tănyana ti oyh ninya soyadmh.
/root/repos/dli_del/data/wav_split_gold/571.wav	Tiki – maqniwq 
/root/repos/dli_del/data/wav_split_gold/1219.wav	"sooh myaqni măkodah sinh andadǣmh,"
/root/repos/dli_del/data/wav_split_gold/1080.wav	tăŋociyedaq mad malh tyenyewin».
/root/repos/dli_del/data/wav_split_gold/1697.wav	 [Nyeracbortʃiwo]
/root/repos/dli_del/data/wav_split_gold/52.wav	Tiki mǣǣna ŋănih raciyawaq yaŋgu.
/root/repos/dli_del/data/wav_split_gold/519.wav	ilanda ŋoka. 
/root/repos/dli_del/data/wav_split_gold/16.wav	"padnăwami tǣwi""."
/root/repos/dli_del/data/wav_split_gold/1660.wav	 aa.
/root/repos/dli_del/data/wav_split_gold/267.wav	"ti wǣsakoŋǣ ayadmh – anyaawana, Dudinkaana ŋǣya, "
/root/repos/dli_del/data/wav_split_gold/1376.wav	"tad widărawadih yaănandih sadih nikli,"
/root/repos/dli_del/data/wav_split_gold/1208.wav	pyelyeynyana todasyati ŋuliq parkăsipoyq.
/root/repos/dli_del/data/wav_split_gold/190.wav	Tyew' ŋar 
/root/repos/dli_del/data/wav_split_gold/1302.wav	mi pǣdăra yah orkiqyaq nyumda ŋămgǣ?
/root/repos/dli_del/data/wav_split_gold/1285.wav	"irir ti ӯbtaana pǣwdyaănda ăyasyanyoq,"
/root/repos/dli_del/data/wav_split_gold/1470.wav	numh siryemyawa. 
/root/repos/dli_del/data/wav_split_gold/1628.wav	Tadtikaad tadaw nyabakoda nyencyuwqniwq maqniwq: 
/root/repos/dli_del/data/wav_split_gold/1.wav	sawa nyeǣǣy (săwă nye). 
/root/repos/dli_del/data/wav_split_gold/1710.wav	“Syancyokuni ǣwakuni lǣtambanq manʹ poyorcʹ andadmh.q
/root/repos/dli_del/data/wav_split_gold/198.wav	"ubta ŋǣ""nim' tyuku ŋǣd nikadaŋga"""
/root/repos/dli_del/data/wav_split_gold/585.wav	   maqniwq –
/root/repos/dli_del/data/wav_split_gold/429.wav	tǣwqniqimh. 
/root/repos/dli_del/data/wav_split_gold/927.wav	"Muŋgoq pyay ăbimh mănǣkărta nida mănǣsah tămna nidya nyǎqmǣq, "
/root/repos/dli_del/data/wav_split_gold/203.wav	ti tiki' ni' yusyebtalambido'.
/root/repos/dli_del/data/wav_split_gold/1223.wav	"tyuqud nǣkăltawā anih, mănʹ tikaawaăd tiwa adăŋguwwa. "
/root/repos/dli_del/data/wav_split_gold/1003.wav	"«Irikǣh,"
/root/repos/dli_del/data/wav_split_gold/1336.wav	"nuwoh saryoăna maqniwh siqiw yurh uryodah maqniwq ǣŋgrimh mǣqŋawaq, "
/root/repos/dli_del/data/wav_split_gold/1393.wav	"«Tyuku ilăŋgaw tarsiq wǣwa,"
/root/repos/dli_del/data/wav_split_gold/238.wav	"Ta""alʹcyuna yolʹcye""maadando', mǣǣ""na"" tiki lyekaraa""na"" "
/root/repos/dli_del/data/wav_split_gold/372.wav	wadakoyemi tǣwrair. 
/root/repos/dli_del/data/wav_split_gold/1364.wav	"Yath taryemh ilyewa anih, "
/root/repos/dli_del/data/wav_split_gold/223.wav	"tanyana pon' mi""niwam'. "
/root/repos/dli_del/data/wav_split_gold/1637.wav	 Lǣqmoqrakow adakad taq! 
/root/repos/dli_del/data/wav_split_gold/825.wav	"tyeda wǣyncyer-yuw mǣw, "
/root/repos/dli_del/data/wav_split_gold/284.wav	"Ti mancaranida tanyawiq ŋǣqniqimq, "
/root/repos/dli_del/data/wav_split_gold/876.wav	«Ti tyedah nyermyaărtanh tǣwa niǐmi yǎŋgu ani yath».
/root/repos/dli_del/data/wav_split_gold/1704.wav	 Mǣkocyayedamyeyh wǣnoh palciq tyaambyeyq. 
/root/repos/dli_del/data/wav_split_gold/651.wav	"Maqniwq tiki yesya arwăda maqniwq,"
/root/repos/dli_del/data/wav_split_gold/33.wav	Tăd tikaăd taqălʹnyayu sidnaq UstʹPortănh sidnaq tǣwraq.
/root/repos/dli_del/data/wav_split_gold/1500.wav	"Tiki nye tiki Nyoyq măqrădyaŋg nyuuyuta asăwaŋǣ tiki nyenyada tiki tiki yunabh,"
/root/repos/dli_del/data/wav_split_gold/1257.wav	"tădtikaad, "
/root/repos/dli_del/data/wav_split_gold/1612.wav	"Yewǣydih syancyoңǣ lyenyewi, "
/root/repos/dli_del/data/wav_split_gold/226.wav	"tikina"" mal' susada""maadana"" ti ta""alʹnya "
/root/repos/dli_del/data/wav_split_gold/835.wav	tiki ŋăcyekǣr ŋarmdaki.
/root/repos/dli_del/data/wav_split_gold/1055.wav	"«Irikǣh,"
/root/repos/dli_del/data/wav_split_gold/600.wav	nibqnanda pindaq ŋǣdăŋguw»  
/root/repos/dli_del/data/wav_split_gold/1576.wav	Ti nyabi asawanh nyumda miqңaq pǣdaraana mayandorcʹ owǣmda nyabi asawar nyemda aye.  
/root/repos/dli_del/data/wav_split_gold/689.wav	yedămda sotăki tuyesăkomda manăpyah nih ŋodh tănănakih.
/root/repos/dli_del/data/wav_split_gold/713.wav	Tyukumh tyedah măqnǣqwaq».
/root/repos/dli_del/data/wav_split_gold/1633.wav	Nyabakoonda maqniwq: 
/root/repos/dli_del/data/wav_split_gold/1651.wav	ǣǣǣ mi tincyami. 
/root/repos/dli_del/data/wav_split_gold/939.wav	"Ti tănya mǣ anih syalănda tyaah mǣydanyoq ti,"
/root/repos/dli_del/data/wav_split_gold/70.wav	tikiq tănyana mǣnaq tiki tiq lyekarmh
/root/repos/dli_del/data/wav_split_gold/838.wav	"Tyey, Muŋgoq pyay abi laănăkomh nidawh pilibth aqnaqnidawh,"
/root/repos/dli_del/data/wav_split_gold/1265.wav	"«Puucyow, tădawă tyedăawh mǣw!»"
/root/repos/dli_del/data/wav_split_gold/751.wav	siqmi ŋǣdăraărkărh». 
/root/repos/dli_del/data/wav_split_gold/990.wav	tyukuni ilh!»
/root/repos/dli_del/data/wav_split_gold/165.wav	"tikaăd ti ti"" lyekar ŋobtiki taykuy mǣǣd Dudinkaăd ŋǣda."
/root/repos/dli_del/data/wav_split_gold/606.wav	Maqniwq mi:
/root/repos/dli_del/data/wav_split_gold/1448.wav	"Nikanda nyenǣy ubtădmh niryeta ŋarka ăr tăniwāsʹ,"
/root/repos/dli_del/data/wav_split_gold/1644.wav	 Piyakoowami udq tawnaw piyakoowami siwi sǣrkana yesya yaңgabcyami
/root/repos/dli_del/data/wav_split_gold/277.wav	"tǣda a, "
/root/repos/dli_del/data/wav_split_gold/1608.wav	Nyabi abyeyq taңocyaңgana aniq sidya abi ilyeңaah. 
/root/repos/dli_del/data/wav_split_gold/776.wav	Ta susaya
/root/repos/dli_del/data/wav_split_gold/743.wav	"Syaah unăndh nyǎqămbădakǣdā,"
/root/repos/dli_del/data/wav_split_gold/1161.wav	Ŋămgǣrida syer-aya yembaqăyq.
/root/repos/dli_del/data/wav_split_gold/542.wav	Tiki?
/root/repos/dli_del/data/wav_split_gold/1234.wav	"ta ŋaruwnanda mǣǣna siqmi yootaana siqmi yǎdpinwa maqniwq,"
/root/repos/dli_del/data/wav_split_gold/1027.wav	"tăryemh sirŋadǣmh anih, "
/root/repos/dli_del/data/wav_split_gold/1185.wav	ti maqniwq ti ādmh».
/root/repos/dli_del/data/wav_split_gold/1021.wav	"Punaaw maqniwq: «Ŋōrcʹ mănʹ widărăbqnani,"
/root/repos/dli_del/data/wav_split_gold/1719.wav	pǣdaranh ayasʹ. 
/root/repos/dli_del/data/wav_split_gold/209.wav	"tikad ŋamcidi' nyaŋotakǣ"", "
/root/repos/dli_del/data/wav_split_gold/1015.wav	"Ŋămgǣ păsi nyu ŋanih yenărmana piŋgu, "
/root/repos/dli_del/data/wav_split_gold/489.wav	Tărcya ŋǣbtoh tiki yaăndoh aŋguq. 
/root/repos/dli_del/data/wav_split_gold/1554.wav	"sidya ŋǣdădyoda ŋǣdălyowanondih, "
/root/repos/dli_del/data/wav_split_gold/1154.wav	mănʹ myakni ăyadmh». 
/root/repos/dli_del/data/wav_split_gold/682.wav	"adăananda maqniwq: «akǣh,"
/root/repos/dli_del/data/wav_split_gold/1307.wav	"A, luk luk lukoh, ti lukqyaq."
/root/repos/dli_del/data/wav_split_gold/1062.wav	"«Kălǣ,"
/root/repos/dli_del/data/wav_split_gold/384.wav	Nyenǣy myaq. 
/root/repos/dli_del/data/wav_split_gold/414.wav	ŋaaq turiănda.
/root/repos/dli_del/data/wav_split_gold/316.wav	"] W nicowʹya Pyelyadki, da?"
/root/repos/dli_del/data/wav_split_gold/1616.wav	"Taryemh syanri unandh yadwi uh Lǣqmoqrakor  usuwǣy yalyah turcyati, "
/root/repos/dli_del/data/wav_split_gold/34.wav	"Sowoc Oktyabrʹskiy ŋǣǣqnyu""."
/root/repos/dli_del/data/wav_split_gold/160.wav	"Koralʹ' myud tămna syanaw ti a"". "
/root/repos/dli_del/data/wav_split_gold/163.wav	"nyenǣy nyenǣcya"" lyekar"" to"". "
/root/repos/dli_del/data/wav_split_gold/1083.wav	"«Yǎŋgu, aăi»."
/root/repos/dli_del/data/wav_split_gold/392.wav	tiki sidya ŋămyamda turinh păradambiiyuda.
/root/repos/dli_del/data/wav_split_gold/1198.wav	«Nyenǣciyekocya myattyu». 
/root/repos/dli_del/data/wav_split_gold/847.wav	"adăda taāŋaruwna puucyaŋǣ ăya,"
/root/repos/dli_del/data/wav_split_gold/444.wav	"«Tădawa, tad yadălmani manʹ mayandorti odǣmh. "
/root/repos/dli_del/data/wav_split_gold/1273.wav	"Muŋgoh pyay ăbi maqniwq, "
/root/repos/dli_del/data/wav_split_gold/774.wav	"ŋămgǣ towna,"
/root/repos/dli_del/data/wav_split_gold/436.wav	" arădh nyabi ǣw uyuh nyayuh ăwā ibya yabdā aniq tiki mădăŋguda,"
/root/repos/dli_del/data/wav_split_gold/668.wav	"anyedămh,"
/root/repos/dli_del/data/wav_split_gold/1308.wav	"Maqniwq: «Ŋobh syudbyako luk, "
/root/repos/dli_del/data/wav_split_gold/82.wav	"tiki abcyangaw tărcya ŋǣwisʹ, mănʹ ărqni sǣwaqnani manǣsqnisawawh."
/root/repos/dli_del/data/wav_split_gold/1488.wav	"ŋaat myadotoh nyana,"
/root/repos/dli_del/data/wav_split_gold/1392.wav	Imi yadǣrŋa: 
/root/repos/dli_del/data/wav_split_gold/1278.wav	taryemh ti ilyenaawaand tyedah laăna yah nyenǣcyaŋǣ wunin andh».
/root/repos/dli_del/data/wav_split_gold/1505.wav	"Tyuku, tiki nyend yusyedasʹh mih nih paŋglyokoh nih nultawǣda, "
/root/repos/dli_del/data/wav_split_gold/1102.wav	 ŋuwqmaq. 
/root/repos/dli_del/data/wav_split_gold/1069.wav	«Yah taborkana nyenǣcʹh ancyerq ilyeŋgu?»
/root/repos/dli_del/data/wav_split_gold/122.wav	Mi ŋǣya tikaawmh maldyoyŋǣ taminni ŋănih nyeri
/root/repos/dli_del/data/wav_split_gold/1106.wav	"taki mimh osyanyoq,"
/root/repos/dli_del/data/wav_split_gold/957.wav	paryeŋodah yanh maqniwq ŋǣdălyorcʹ mǣtini maqniwq ănni ti adan?».
/root/repos/dli_del/data/wav_split_gold/323.wav	taki yalyah paraŋodanh ayadmh.
/root/repos/dli_del/data/wav_split_gold/1284.wav	"tyedah maqniwq ti, "
/root/repos/dli_del/data/wav_split_gold/598.wav	"man-in,"
/root/repos/dli_del/data/wav_split_gold/302.wav	lyekarq lidoh manǣsqniqimh. 
/root/repos/dli_del/data/wav_split_gold/634.wav	"Manʹ ti ŋǣqniwh,"
/root/repos/dli_del/data/wav_split_gold/87.wav	Sabye ponh niwacʹ mǣŋguq. 
/root/repos/dli_del/data/wav_split_gold/960.wav	"«Irikǣ, tălyahtălyah!»"
/root/repos/dli_del/data/wav_split_gold/202.wav	"Tiki nyeri awi awi"" ti"" ŋamca"" ti taryem' "
/root/repos/dli_del/data/wav_split_gold/1481.wav	 ti Miniko ayeda.
/root/repos/dli_del/data/wav_split_gold/35.wav	 Aga. Tăka?]
/root/repos/dli_del/data/wav_split_gold/1332.wav	Siqiw yurh uryodah ǣŋgă̌rimh mǣqŋaq. 
/root/repos/dli_del/data/wav_split_gold/478.wav	"Ŋa, ti tărcyaq tănyaŋguq,"
/root/repos/dli_del/data/wav_split_gold/280.wav	"Ti tarcya abcyaŋgana awiq tiqnyoq tyuku, tyuku ǣtah tyaanyaŋi ǣwana"
/root/repos/dli_del/data/wav_split_gold/1252.wav	Manih tyedah nye nyumih nyedănda anăwanh ărwa siqmi tăryemh mayedambiwa. 
/root/repos/dli_del/data/wav_split_gold/1244.wav	"Ŋani syanrindoh unandh ilyenakiq,"
/root/repos/dli_del/data/wav_split_gold/683.wav	"ŋopoykocyah itwaq osqmah mănyaq unyaăwana itămd maqniwq idmh wunin tǣwăbăsyetuh,"
/root/repos/dli_del/data/wav_split_gold/1370.wav	Syaqnǣqrinda unănda ŋǣbqnanda ŋodh yaămh madăwiq.
/root/repos/dli_del/data/wav_split_gold/270.wav	"Nid nih manq: «Ou, tyukor amgǣǣrtmh pǣrmi niŋaq». "
/root/repos/dli_del/data/wav_split_gold/649.wav	"yalyah paryeŋoda maqnisawh,"
/root/repos/dli_del/data/wav_split_gold/366.wav	 maqniwh.
/root/repos/dli_del/data/wav_split_gold/367.wav	"«Tyedah, maqnidă̌mh ŋamgǣ taryemh ǣnyakǣdmh?"
/root/repos/dli_del/data/wav_split_gold/332.wav	"ŋobtiki yawh ǣwăna siqiw wǣbărkaqya,"
/root/repos/dli_del/data/wav_split_gold/1634.wav	“Ңuliq yabtkoyenh mi siqmi nyon adaq sidya abinh sit nidmh mitq.q 
/root/repos/dli_del/data/wav_split_gold/1733.wav	Tiki amgǣ? 
/root/repos/dli_del/data/wav_split_gold/260.wav	"oyh nid anǣydoh tyukod, tayh tǣwqmaadandoh wstryetʃyeymbawidoncʹ, pidawadoh urkari miqmiqmaq"
/root/repos/dli_del/data/wav_split_gold/241.wav	"Tiki nyercyuna tiki, tiki abcyal mǣǣna,"
/root/repos/dli_del/data/wav_split_gold/243.wav	"taŋok"" nyenǣcya"", "
/root/repos/dli_del/data/wav_split_gold/629.wav	Nyabi nyekocya ŋanih inomda.
/root/repos/dli_del/data/wav_split_gold/1585.wav	Minikoh. 
/root/repos/dli_del/data/wav_split_gold/1566.wav	Tadawa myadoh nimnya tad ңadimyandoh taki myakq tad tǣwwadoh yaandoh ti ңǣqniwq. 
/root/repos/dli_del/data/wav_split_gold/1110.wav	"«Ŋǣy, păncyerŋan? – mancyeti –"
/root/repos/dli_del/data/wav_split_gold/305.wav	"tiq liq anih lyekarq manǣqyadoh, "
/root/repos/dli_del/data/wav_split_gold/1357.wav	"«Tyuquy tiq ninya ma yamb idya tănya, "
/root/repos/dli_del/data/wav_split_gold/1245.wav	"ŋanih ŋobăŋguna Muŋgo pyay ăbi tăryemh incyelye,"
/root/repos/dli_del/data/wav_split_gold/1111.wav	ŋăwǣd pyūn?»
/root/repos/dli_del/data/wav_split_gold/1344.wav	Ŋuliq tǣta ănya. 
/root/repos/dli_del/data/wav_split_gold/1150.wav	Syanh orcyatida ăncyerkart nida pirasq.
/root/repos/dli_del/data/wav_split_gold/201.wav	tiki pya taryem' 
/root/repos/dli_del/data/wav_split_gold/1025.wav	"Yed, yed pinqniwq."
/root/repos/dli_del/data/wav_split_gold/1228.wav	tyedanda tyeda ti piribtyawa wadaqnanda nyeda ŋǣdaki.
/root/repos/dli_del/data/wav_split_gold/415.wav	"Ti maqniwq mi,"
/root/repos/dli_del/data/wav_split_gold/67.wav	pǣwsyumnyaŋi raciyah laănawamh tǣwamih.
/root/repos/dli_del/data/wav_split_gold/746.wav	Maqniwq: 
/root/repos/dli_del/data/wav_split_gold/423.wav	"«Nyemh odāmh, ambi»"
/root/repos/dli_del/data/wav_split_gold/934.wav	"ŋanih tah ih maŋg, "
/root/repos/dli_del/data/wav_split_gold/1103.wav	«Tyedah syaranih nyaarh sawna».
/root/repos/dli_del/data/wav_split_gold/872.wav	"unyaăwana mănʹ,"
/root/repos/dli_del/data/wav_split_gold/1274.wav	syudbyanda nye nyunh maqniwq:
/root/repos/dli_del/data/wav_split_gold/413.wav	"Tăsiy nye ŋāwkamda tunh păradambida,"
/root/repos/dli_del/data/wav_split_gold/1159.wav	"mǣqyaqmi tănyasyanyoq, "
/root/repos/dli_del/data/wav_split_gold/1496.wav	"«Nyoyq mărălyaŋgh maqniwq nye nyu maqniwq tyaănd syadota nye maqniwq syernaq tǣta nyawaq, "
/root/repos/dli_del/data/wav_split_gold/607.wav	«Yalyah paryeŋoda nyani maqniwq mi –
/root/repos/dli_del/data/wav_split_gold/1464.wav	tuh yesyamh anā –
/root/repos/dli_del/data/wav_split_gold/246.wav	"syanri yalya' mancaya niw' ŋa"". "
/root/repos/dli_del/data/wav_split_gold/650.wav	maqniwq sǣwni sarădawanh ărwā».
/root/repos/dli_del/data/wav_split_gold/1706.wav	"Pyeңg-yuda ңobth mǣ aniq ңobth mǣwi pyeңg-yuta myuq wadaaqnaqta mǣyda, "
/root/repos/dli_del/data/wav_split_gold/631.wav	"nyumda maqniwq,"
/root/repos/dli_del/data/wav_split_gold/1434.wav	yudmh pǣdaryeqǣq».
/root/repos/dli_del/data/wav_split_gold/134.wav	Ŋǣya tăd(ti)kad raciyaăna nămdqmaădandoh lucaq toŋowq. 
/root/repos/dli_del/data/wav_split_gold/1480.wav	"Paŋglyokoh nih yusyebtaqmaawamda tyenyedasyē anih, "
/root/repos/dli_del/data/wav_split_gold/1100.wav	ŋaaq». 
/root/repos/dli_del/data/wav_split_gold/1545.wav	"ărămh nisʹ mǣsq tiki asăwaad ŋacyekimh o tiki nyer,"
/root/repos/dli_del/data/wav_split_gold/1001.wav	"«Mănʹ ărqni ăbărtin,"
/root/repos/dli_del/data/wav_split_gold/953.wav	"«Uu, maqniwq, yebcotakō,"
/root/repos/dli_del/data/wav_split_gold/971.wav	«Ŋămgǣ siyakăwna laănan Syudbya wǣsakō?»
/root/repos/dli_del/data/wav_split_gold/379.wav	 ti ŋǣqniwh ărta mandawa. 
/root/repos/dli_del/data/wav_split_gold/1597.wav	 Ti ңaaq ti. 
/root/repos/dli_del/data/wav_split_gold/1044.wav	ŋokaq niqimŋaq.
/root/repos/dli_del/data/wav_split_gold/1690.wav	"	A mi Lorcǣq? "
/root/repos/dli_del/data/wav_split_gold/613.wav	"mimh, poymh womdabăda maqniwq nye ŋǣqniwah ilyewanda yambănh,"
/root/repos/dli_del/data/wav_split_gold/831.wav	Muŋgoh pyaq ninya maqniwq lăbtǣyh myunya maqniw parkasih lyasyowǣnănyoq – 
/root/repos/dli_del/data/wav_split_gold/189.wav	"Ti tǣnd tǣnd a""... a""ma"". "
/root/repos/dli_del/data/wav_split_gold/1707.wav	tadtikaad urabida. 
/root/repos/dli_del/data/wav_split_gold/1056.wav	"alya sānwonda,"
/root/repos/dli_del/data/wav_split_gold/741.wav	"Syaarinda unăndh nyǎqămbădakǣdā anih,"
/root/repos/dli_del/data/wav_split_gold/1131.wav	yuq tibya».
/root/repos/dli_del/data/wav_split_gold/391.wav	"nyenǣy tumh mǣqmiq aniq,"
/root/repos/dli_del/data/wav_split_gold/1148.wav	"tăsiy maqniwq,"
/root/repos/dli_del/data/wav_split_gold/320.wav	Ŋămgǣ tăryemh ǣnăkǣwaq? Mănyaq ărqnaq piidănaq niwaq amyedambyuq.
/root/repos/dli_del/data/wav_split_gold/662.wav	adădoh tănya 
/root/repos/dli_del/data/wav_split_gold/762.wav	Tiki muŋgq purombh malye āwaq.
/root/repos/dli_del/data/wav_split_gold/907.wav	"urka tusipoyh mănʹ yedh myu,"
/root/repos/dli_del/data/wav_split_gold/617.wav	ni aŋguh».
/root/repos/dli_del/data/wav_split_gold/785.wav	Ŋămgǣh pirkăna puucya pǣwsyumyah nyana onawăncʹ ărwa. 
/root/repos/dli_del/data/wav_split_gold/703.wav	Siqiw ăbir itămdoh ŋămancʹ malh sanǣydh.
/root/repos/dli_del/data/wav_split_gold/1724.wav	 Tiki ǣǣh saryo anyana aya? 
/root/repos/dli_del/data/wav_split_gold/1371.wav	"Yaămh madăwiq anih, "
/root/repos/dli_del/data/wav_split_gold/773.wav	Sira susaya –
/root/repos/dli_del/data/wav_split_gold/480.wav	Tikiqyad maqniwq tărcyaq
/root/repos/dli_del/data/wav_split_gold/815.wav	«Ŋii yawna nyon yadǣrcyatuh».
/root/repos/dli_del/data/wav_split_gold/576.wav	«Nyaanda man-in.
/root/repos/dli_del/data/wav_split_gold/739.wav	"Panăt nyǎqămaqdā, "
/root/repos/dli_del/data/wav_split_gold/220.wav	"tay', "
/root/repos/dli_del/data/wav_split_gold/621.wav	"tiki pǣwdyumh nǣkălŋa anih maqniwq,"
/root/repos/dli_del/data/wav_split_gold/1096.wav	"«Nyukcyā,"
/root/repos/dli_del/data/wav_split_gold/639.wav	ŋămgǣǣrtăda yǎŋgu. 
/root/repos/dli_del/data/wav_split_gold/850.wav	nyunda nyumh ti ŋǣqniwh.
/root/repos/dli_del/data/wav_split_gold/181.wav	"takaad luca"" tiki"" ŋani' mancaranaŋǣ towi"" "
/root/repos/dli_del/data/wav_split_gold/1303.wav	Ŋămcaqyaqda ŋăwăr orkih toqǒla ŋăwăr [nyeracbortʃiwo]. 
/root/repos/dli_del/data/wav_split_gold/288.wav	U?
/root/repos/dli_del/data/wav_split_gold/1716.wav	  maqniwq oqryeqyaq tosʹ aniq oqryeqyaq ңam-ydasʹ
/root/repos/dli_del/data/wav_split_gold/116.wav	sisyurăa ŋǣsyǎti.
/root/repos/dli_del/data/wav_split_gold/1325.wav	ănoh tǣta. 
/root/repos/dli_del/data/wav_split_gold/594.wav	"piliq tărcyah tănyaŋgobǣq,"
/root/repos/dli_del/data/wav_split_gold/1099.wav	"«Tyuku yesya salh yedh ninih manondh niqnimh,"
/root/repos/dli_del/data/wav_split_gold/972.wav	«Ŋawǣt sidq?»
/root/repos/dli_del/data/wav_split_gold/1425.wav	"tincyamh ŋădimdye,"
/root/repos/dli_del/data/wav_split_gold/1668.wav	 Warңǣ nye. 
/root/repos/dli_del/data/wav_split_gold/717.wav	"«Mad manǣqmǣqmi yaŋgō, "
/root/repos/dli_del/data/wav_split_gold/547.wav	Ti taryemh maqniw tyeda nyuda adabida –
/root/repos/dli_del/data/wav_split_gold/1286.wav	maqniwq tyuku yaāmd maqniwq ŋulih malămbida.
/root/repos/dli_del/data/wav_split_gold/787.wav	Tyaanyana ănyaawana sinyana ŋăyebǣy ŋăcyekih yarmh namda. 
/root/repos/dli_del/data/wav_split_gold/771.wav	taminda aya». 
/root/repos/dli_del/data/wav_split_gold/1213.wav	"tăryemh incyelye anih,"
/root/repos/dli_del/data/wav_split_gold/933.wav	" «Tarsih wǣwadamnyoh ŋămgǣ wadyeqŋaw,"
/root/repos/dli_del/data/wav_split_gold/1348.wav	Tuh yash putkor syaqniqrinda ŋo(d)h ŋǣbqnanda ŋo(d)h –
/root/repos/dli_del/data/wav_split_gold/1396.wav	padraah ăn maqniwq marcʹ lǣni tyaah maqniwq siibtasʹ ŋǣwah inyaananda solada tǣsuyh.
/root/repos/dli_del/data/wav_split_gold/1051.wav	yaah lăŋgana mănʹ ŋamdyodadmh».
/root/repos/dli_del/data/wav_split_gold/784.wav	nyumi maqniwq ŋămgǣ ŋǣdaraw?»
/root/repos/dli_del/data/wav_split_gold/374.wav	«Yah ŋilh sǣytadmh».
/root/repos/dli_del/data/wav_split_gold/322.wav	"Mancʹwan paranodah ŋǣdatawǣdmh,"
/root/repos/dli_del/data/wav_split_gold/1418.wav	nyenǣcʹh ŋokăwā anih.
/root/repos/dli_del/data/wav_split_gold/511.wav	Ŋămgǣnda pad ŋǣdaki?
/root/repos/dli_del/data/wav_split_gold/1603.wav	Nikadoh mancʹti ңamgǣ moyopid yaananat tiwak wakcyamh niwiq tatǣyq. 
/root/repos/dli_del/data/wav_split_gold/889.wav	"«Wǣǣy, tădaw tiki pasih nyuqyaq ŋanih pyadoh kălyey tădaw tyukoow!»"
/root/repos/dli_del/data/wav_split_gold/43.wav	nye ŋăcyekǣmi (ŋătʃyekǣmi) nyaărpoy podasʹ.
/root/repos/dli_del/data/wav_split_gold/460.wav	"Tikăāyud, mănʹ tăryemh syertawǣǣyuni."
/root/repos/dli_del/data/wav_split_gold/450.wav	"Maqniwq, yaah yernya, "
/root/repos/dli_del/data/wav_split_gold/1669.wav	 Nyunyoow nyunyoow ayel taңǣǣyq saryor anoowq nyunyoow nyunyoow. 
/root/repos/dli_del/data/wav_split_gold/452.wav	Maqniwq ŋănondih myuh tădwǣǣh.
/root/repos/dli_del/data/wav_split_gold/580.wav	"«Ŋani nyanda asawanh onaŋguqmaq,"
/root/repos/dli_del/data/wav_split_gold/1126.wav	" Syudbya wǣsăko nidawh uraq yesya mih yedh,"
/root/repos/dli_del/data/wav_split_gold/1276.wav	mănʹ andadmh». 
/root/repos/dli_del/data/wav_split_gold/720.wav	"adăndoh panoqmanh,"
/root/repos/dli_del/data/wav_split_gold/1447.wav	Tǣri yarumā anih ŋarka Tǣsʹda nikanda waqawah pomna ulcotoliq. 
/root/repos/dli_del/data/wav_split_gold/767.wav	Puucya maqniwq: «Tiki nyūmnani ŋămgǣ ŋuyǎmlǣyda» 
/root/repos/dli_del/data/wav_split_gold/211.wav	"Manya"" tǣri yaana mǣnaŋǣ mǣdwa"""
/root/repos/dli_del/data/wav_split_gold/590.wav	"ŋanihtyaah onăŋguh,"
/root/repos/dli_del/data/wav_split_gold/1251.wav	«adā tara ŋabcata». 
/root/repos/dli_del/data/wav_split_gold/566.wav	"«Păsimda tunh părădambi,"
/root/repos/dli_del/data/wav_split_gold/915.wav	wadyetănakǣw ti».
/root/repos/dli_del/data/wav_split_gold/1407.wav	Ŋanih andadmh punyah. 
/root/repos/dli_del/data/wav_split_gold/153.wav	"takad koralyadăwa"" "
/root/repos/dli_del/data/wav_split_gold/417.wav	Siirtyanh maqniwq:
/root/repos/dli_del/data/wav_split_gold/1362.wav	"ănyaŋǣǣna, ănyaŋǣǣna yǎŋgodawa,"
/root/repos/dli_del/data/wav_split_gold/910.wav	maqniwq.
/root/repos/dli_del/data/wav_split_gold/1732.wav	Manʹ obcow maqniwq ңamdyoqmada paridye. 
/root/repos/dli_del/data/wav_split_gold/1134.wav	"Ti nyambor Syudbya wǣsăko, "
/root/repos/dli_del/data/wav_split_gold/1519.wav	tuh yesyakomda. 
/root/repos/dli_del/data/wav_split_gold/518.wav	"Ti taŋaruwnanda maqniwq tǣta,"
/root/repos/dli_del/data/wav_split_gold/684.wav	itwaq osh». 
/root/repos/dli_del/data/wav_split_gold/1000.wav	Pidaaw ma:
/root/repos/dli_del/data/wav_split_gold/1400.wav	Sirah yambana myuyko myuykota siqimnya maqniwq tuda ŋădʹsyati
/root/repos/dli_del/data/wav_split_gold/1473.wav	"ŋobtiki syenyah mădăbăwi yaaănda,"
/root/repos/dli_del/data/wav_split_gold/888.wav	ti tad tyaănyah silih anih siqiw ăbărtyeqǣ ŋanih tikăana pir-yaqyaqŋaq. 
/root/repos/dli_del/data/wav_split_gold/364.wav	"«Ti, yah ŋilh sǣyqnidamh,"
/root/repos/dli_del/data/wav_split_gold/1032.wav	asăwa ŋăcyekǣr  Muŋgoh pyay ăbir. 
/root/repos/dli_del/data/wav_split_gold/551.wav	"Tarsih maqniwq ŋămgǣ owi,"
/root/repos/dli_del/data/wav_split_gold/1173.wav	ŋanih manǣqpăqni săwăraa».
/root/repos/dli_del/data/wav_split_gold/1461.wav	ŋămgǣŋǣ mǣtaq yath miq tănyacʹ tikăana.
/root/repos/dli_del/data/wav_split_gold/1022.wav	"puna yednih tyer ma pirdirtanih mănʹ widărăbqnani maqniwq yoŋgmi săp-ir tyuku tibkaqyaqănăni,"
/root/repos/dli_del/data/wav_split_gold/721.wav	syurtye ŋamdidh.
/root/repos/dli_del/data/wav_split_gold/748.wav	maqniwq ŋopoyŋǣ nidmh ayodh.
/root/repos/dli_del/data/wav_split_gold/1335.wav	"nuwoh adăna, "
/root/repos/dli_del/data/wav_split_gold/1333.wav	ănoh tǣtā.
/root/repos/dli_del/data/wav_split_gold/369.wav	" paryeŋodah_(paraŋodah) mǣnh,"
/root/repos/dli_del/data/wav_split_gold/893.wav	Nidya ŋawǣq.
/root/repos/dli_del/data/wav_split_gold/640.wav	"Tinyoh, tăkād tiki syurămbădaqyaqănda yadănh,"
/root/repos/dli_del/data/wav_split_gold/1398.wav	"Ŋǣwah inyaananda maqniwq padraah ănmh marcʹ lǣni tyaah maqniwq ǣdh ǣkaādtawǣ̄,"
/root/repos/dli_del/data/wav_split_gold/1441.wav	ǣdolawidh.
/root/repos/dli_del/data/wav_split_gold/501.wav	"Ti nyaandoh man-in,"
/root/repos/dli_del/data/wav_split_gold/63.wav	"ti taki dalʹniyarka ŋǣsinh, "
/root/repos/dli_del/data/wav_split_gold/830.wav	"«Nyuml,  maqniwq – Muŋgoh pyay ăbi  ŋǣyawa»."
/root/repos/dli_del/data/wav_split_gold/381.wav	 Ti syurămbăda aiwă.
/root/repos/dli_del/data/wav_split_gold/1383.wav	Maqniwq lăŋgh nyah nǣǣ̄dādawa maqniwq. 
/root/repos/dli_del/data/wav_split_gold/99.wav	"tăryemh tiki limh syakălpa āndaq, tăryemh yadǣrŋaq."
/root/repos/dli_del/data/wav_split_gold/1478.wav	"tiki yaanh tǣwiq anih tădaw,"
/root/repos/dli_del/data/wav_split_gold/959.wav	uh mosawǣy arwh syudbyamh.
/root/repos/dli_del/data/wav_split_gold/924.wav	tyuku yedar maqniwq tyuku tǣ tuyesăr ilyewah yambanh maqniwq ti ŋămgǣda ŋǣdaki».
/root/repos/dli_del/data/wav_split_gold/340.wav	 Ŋobtiki wadō:
/root/repos/dli_del/data/wav_split_gold/853.wav	tyedănanda maqniwq ŋămgǣ sidyambonih tyedah mănih ?»
/root/repos/dli_del/data/wav_split_gold/699.wav	 tăŋocyamh tyersyalămdawiq maqniwq ŋilikaq».
/root/repos/dli_del/data/wav_split_gold/1489.wav	pida asăwanda nyana.
/root/repos/dli_del/data/wav_split_gold/448.wav	Maqniwq:
/root/repos/dli_del/data/wav_split_gold/1433.wav	"nyaărq Tǣsʹdani yanh pyaw, "
/root/repos/dli_del/data/wav_split_gold/1531.wav	Maqniwq: 
/root/repos/dli_del/data/wav_split_gold/1737.wav	 Manʹ obcow maqniwq sidya syurambadah uyumgart nyamda ni nyertyembyuq.  
/root/repos/dli_del/data/wav_split_gold/948.wav	"toqyanda tyaănyaŋi ǣwanh, "
/root/repos/dli_del/data/wav_split_gold/494.wav	"syaŋok yǎmh ŋǣdaki, "
/root/repos/dli_del/data/wav_split_gold/1555.wav	nyabi pida ŋaāt asăwada ŋǣwanonda nyabi nyabi tyedah tyuku nyunda nisya ŋǣwanonda Noy mărădyaŋg.
/root/repos/dli_del/data/wav_split_gold/593.wav	"Maqniwq: «Nyaanda man-in,"
/root/repos/dli_del/data/wav_split_gold/290.wav	anyaŋi? 
/root/repos/dli_del/data/wav_split_gold/1592.wav	"Maqniw Salyeyakoyaqyeyңǣy Salyeyah sǣqryeqyeyңǣy ңawka sǣqryeqyeymңǣy, "
/root/repos/dli_del/data/wav_split_gold/794.wav	pih yerh yolʹcyandh tiki muŋgh pyula ŋanih myata syuryeqlye tiki puucyar.
/root/repos/dli_del/data/wav_split_gold/1350.wav	Siqiw yurq uryodamda…
/root/repos/dli_del/data/wav_split_gold/1164.wav	"tăsiy yanda ŋǣsomăna wǣrdawǣdā anih,"
/root/repos/dli_del/data/wav_split_gold/730.wav	Tiki puucyar ida yadǣliq.
/root/repos/dli_del/data/wav_split_gold/1011.wav	"syudbya yedda tănyawi anih,"
/root/repos/dli_del/data/wav_split_gold/1085.wav	"Muŋgoh pyay ăbi nyanda tad Syudbya wǣsăkoh pumna Muŋgoh pyay ăbi nidawh nǣkălh, "
/root/repos/dli_del/data/wav_split_gold/1408.wav	"Pida maqniwq: «asăwami maqniw,"
/root/repos/dli_del/data/wav_split_gold/1196.wav	tăryemh sirŋadǣ̄mhsindya nyaŋi ǣwana maqniwq nye nyuda ŋǣwnawh maqniwq tikaăna maqniwq nyenǣciye [nyeracbortʃiwo] tikaăna mǣwi. 
/root/repos/dli_del/data/wav_split_gold/1445.wav	"ǣy,  tikaawaăd tǣri, "
/root/repos/dli_del/data/wav_split_gold/328.wav	"mǣwăndārawaq,"
/root/repos/dli_del/data/wav_split_gold/812.wav	Tiki ŋăcyekǣcyayer niwh ŋarăwq tikayeǣwaad.
/root/repos/dli_del/data/wav_split_gold/1146.wav	"Tad widpăqnănda maqniwq,"
/root/repos/dli_del/data/wav_split_gold/1119.wav	tyedah pirdirtanih tibkami taykuy ti».
/root/repos/dli_del/data/wav_split_gold/1662.wav	" Aa, ʒalyet tʃtobi i nye ubiwali."
/root/repos/dli_del/data/wav_split_gold/985.wav	"«Ŋǣda,"
/root/repos/dli_del/data/wav_split_gold/1684.wav	towani yolʹcyandǣ yolʹcyandǣǣ ora nyu onidoh  onidoh ora nyu ooyaq ooyaq!
/root/repos/dli_del/data/wav_split_gold/666.wav	Ŋǣryoh.
/root/repos/dli_del/data/wav_split_gold/1503.wav	"Narah nyakuyq,"
/root/repos/dli_del/data/wav_split_gold/95.wav	"Tiq skyelyetq, "
/root/repos/dli_del/data/wav_split_gold/1373.wav	"malye salabada ŋo(d)' ti anda,"
/root/repos/dli_del/data/wav_split_gold/837.wav	adada puucyawa.
/root/repos/dli_del/data/wav_split_gold/1713.wav	takad ңanih ңobnyah mǣda. 
/root/repos/dli_del/data/wav_split_gold/848.wav	anyaye tah. 
/root/repos/dli_del/data/wav_split_gold/840.wav	"pida ŋǣ""niwh."
/root/repos/dli_del/data/wav_split_gold/106.wav	mănʹ ŋobh mǣtaqyaqmi ăbtqyami a. 
/root/repos/dli_del/data/wav_split_gold/304.wav	"liq, "
/root/repos/dli_del/data/wav_split_gold/1527.wav	"Tăryemh syanandh mǣnaăndā anih,"
/root/repos/dli_del/data/wav_split_gold/1520.wav	"ǣ̄y, ŋămgǣh pirkana maqniwq sǣwni ŋădimyaq."
/root/repos/dli_del/data/wav_split_gold/620.wav	"tuh ǣwăna mǣ syudbyako adyeq maqniwq tusawǣy pǣwdyu tănyawi anih,"
/root/repos/dli_del/data/wav_split_gold/1395.wav	"Mănʹ pinh tărpiwh anih, "
/root/repos/dli_del/data/wav_split_gold/1183.wav	"maqniwq ŋaătănda maqniwq taŋok tăŋociye tyer maqniwq ŋămgǣq wiqcipoyh wunisaq aŋguq, "
/root/repos/dli_del/data/wav_split_gold/184.wav	"tiki"" ti"" a""ma"" ma""lamba. "
/root/repos/dli_del/data/wav_split_gold/283.wav	tǣtakoqyaq wǣsako ŋǣwi. 
/root/repos/dli_del/data/wav_split_gold/777.wav	ŋămgǣ towna.
/root/repos/dli_del/data/wav_split_gold/1472.wav	"Tăryemh taslambida syenyey sanda niklăqmaq yaa yaanh tǣwih,"
/root/repos/dli_del/data/wav_split_gold/749.wav	Ilyewah yambanh ŋŏpoyŋǣ ŋokah aidmh».
/root/repos/dli_del/data/wav_split_gold/618.wav	"Ti maqniwq mǣ,"
/root/repos/dli_del/data/wav_split_gold/761.wav	maqniwq.
/root/repos/dli_del/data/wav_split_gold/1340.wav	sirah ŋǣdakih  siqiw yurq uryodamh syaartămboyh nidoh yuribyuq –
/root/repos/dli_del/data/wav_split_gold/1065.wav	«Yāŋgō».
/root/repos/dli_del/data/wav_split_gold/664.wav	"Syaqnibătoh unandoh ŋǣdaki anih,"
/root/repos/dli_del/data/wav_split_gold/1559.wav	asʹ mi yalawaanda aңguqnisawq.
/root/repos/dli_del/data/wav_split_gold/440.wav	«Tad nyernyah tărcya pyamh wadăbăda yaŋgoyǎ».
/root/repos/dli_del/data/wav_split_gold/482.wav	"Maqniwq ti,"
/root/repos/dli_del/data/wav_split_gold/1607.wav	Lǣqmoqrakor tadawa nyabakonda nyah sidyamboңǣ ilyeңaah. 
/root/repos/dli_del/data/wav_split_gold/1260.wav	" acyah măncăbtarkadā,"
/root/repos/dli_del/data/wav_split_gold/458.wav	Ŋămgǣmih ăncyerh ǣnyaki.
/root/repos/dli_del/data/wav_split_gold/1035.wav	mănʹ adami ŋătyena» 
/root/repos/dli_del/data/wav_split_gold/336.wav	"uh talwăwiq,"
/root/repos/dli_del/data/wav_split_gold/1672.wav	Tobiqni yolʹcyandaq a wǣwa yani tyerq anyedoh ayaq kaawǣy!
/root/repos/dli_del/data/wav_split_gold/333.wav	ŋobtiki tarcyaq. 
/root/repos/dli_del/data/wav_split_gold/602.wav	Siirtya punyah aya.
/root/repos/dli_del/data/wav_split_gold/1377.wav	sadih niklǣ̄ anih tiki yaah yernya ănsawǣyh nyeŋǣ tiki ănanda ninya ŋamdyo tikăana aiwa tǣǣyuda ăyaa.
/root/repos/dli_del/data/wav_split_gold/568.wav	maqniwq –
/root/repos/dli_del/data/wav_split_gold/807.wav	asăwa ŋăcyeki ŋulih parkasi yedǣy soyǎwi.
/root/repos/dli_del/data/wav_split_gold/362.wav	«Ŋămgǣ tyukŏona mǣ̄n? » 
/root/repos/dli_del/data/wav_split_gold/54.wav	"Ti brigadirwaq, "
/root/repos/dli_del/data/wav_split_gold/1528.wav	"tuh yesyakoonanda tukocyadamda pyatăbădăandā anih,"
/root/repos/dli_del/data/wav_split_gold/6.wav	"săwawna macampii (săwawna mancambi), "
/root/repos/dli_del/data/wav_split_gold/1415.wav	"Tikaăd ălcoqlǣmh ŋădimdye, "
/root/repos/dli_del/data/wav_split_gold/62.wav	"""Mănih sit nyah ǣǣnih,"
/root/repos/dli_del/data/wav_split_gold/1288.wav	ŋilʹnyarih ma siqiw yǎŋorǣyq mih mǣnh aqawrad.
/root/repos/dli_del/data/wav_split_gold/814.wav	Maqniwq:
/root/repos/dli_del/data/wav_split_gold/1459.wav	"Tănyana unyana noy mimh, "
/root/repos/dli_del/data/wav_split_gold/1723.wav	 ǣǣh saryo abtadasʹ. 
/root/repos/dli_del/data/wav_split_gold/1262.wav	Pǣwdyaăna ŋămgǣ ŋadi?
/root/repos/dli_del/data/wav_split_gold/1133.wav	ŋani taykuy ŋani ŋamgǣ maniyeydawa».
/root/repos/dli_del/data/wav_split_gold/1625.wav	Tadawa mi Lǣqmoqrakor myakanda niwq anʹq aniq nyabakoonda maqniwq mi:
/root/repos/dli_del/data/wav_split_gold/938.wav	Siqiw ăbinda nyewih awiq tiki siqiwh puydoh muŋgoda ŋinh ŋǣdăkiq  tikida niwh anaq minryeq.
/root/repos/dli_del/data/wav_split_gold/37.wav	Nyerdye pǣdariq nyana măncăradmh.
/root/repos/dli_del/data/wav_split_gold/50.wav	"Ti tamălyaŋgăna tyeda' ti tăryemh ŋǣqnyuh, nyerdyenya yanh ŋǣsuqniwamh, "
/root/repos/dli_del/data/wav_split_gold/540.wav	Nyani maqnisawq ŋămyeǣyuda sipa nidih pirasq părădawdawǣyh.
/root/repos/dli_del/data/wav_split_gold/118.wav	tǣri tyaakurkaq anawaq.
/root/repos/dli_del/data/wav_split_gold/205.wav	ti taryem' paradambido'.
/root/repos/dli_del/data/wav_split_gold/1345.wav	"A, nyah tăryemh oda. "
/root/repos/dli_del/data/wav_split_gold/377.wav	tănya tǣwrad.
/root/repos/dli_del/data/wav_split_gold/1506.wav	nultada. 
/root/repos/dli_del/data/wav_split_gold/455.wav	maqniwq.
/root/repos/dli_del/data/wav_split_gold/727.wav	"piiy piina numh pǣwsyumyā anih, "
/root/repos/dli_del/data/wav_split_gold/1047.wav	Syudbya wǣsako mannaqmaq:
/root/repos/dli_del/data/wav_split_gold/1310.wav	maqniwq mi yaah nyah sirta maqniwq. 
/root/repos/dli_del/data/wav_split_gold/1299.wav	" tidǣh tănyawǣ̄ anih ŋǒpoy tidǣŋgăna,"
/root/repos/dli_del/data/wav_split_gold/1620.wav	Tiki abiiyud mǣ nyorakuqulqnidimh Lǣqmoqrakomdih. 
/root/repos/dli_del/data/wav_split_gold/326.wav	yabtkoyenq.   
/root/repos/dli_del/data/wav_split_gold/701.wav	Yedămda nyaqmaq anih myakănda ăya.
/root/repos/dli_del/data/wav_split_gold/1360.wav	ma nyerh orkih yaykocyamh syurŋadamcʹ tikanh».
/root/repos/dli_del/data/wav_split_gold/218.wav	"Manya"" oy' nina "
/root/repos/dli_del/data/wav_split_gold/183.wav	"myadi' nya' sidna"" ana"". "
/root/repos/dli_del/data/wav_split_gold/11.wav	"A mănyaq nyerdyenyāna (< nyerdyenyaăna) tayna ŋilnyana ti Muŋguyh nyana ilyewacʹ (ilyewatʃʹ), koloc ŋǣnyu""."
/root/repos/dli_del/data/wav_split_gold/549.wav	Ti maqniwq ŋani nyunda nyancinh mǣŋguda tarsih idyǎălh tiki ŋacyeki sǣrdaăna a.
/root/repos/dli_del/data/wav_split_gold/723.wav	«Ŋulih ǣtad».
/root/repos/dli_del/data/wav_split_gold/1358.wav	tănyaŋgu».
/root/repos/dli_del/data/wav_split_gold/484.wav	Ti nyernyad pidyebidoh maqniwq yah tyerq nyenǣcʹq maqniwq ŋăworcipoyh maqniwh sǣrdaana anyaŋi yaăna aŋgaq maqniwq.
/root/repos/dli_del/data/wav_split_gold/395.wav	"«Nisyǎrq, torowa."
/root/repos/dli_del/data/wav_split_gold/1630.wav	Nyabakoda tuh sidya ǣwuwna nyorakuqlada. 
/root/repos/dli_del/data/wav_split_gold/504.wav	Ti ŋǣqniwq mandānăwa punyah ǣbqnand.
/root/repos/dli_del/data/wav_split_gold/818.wav	"Ŋămyǎbtambsyatida, nyebyadănda mǣqŋăda. "
/root/repos/dli_del/data/wav_split_gold/1627.wav	Maqniwq sidya abiih siqmi nyaqamңaancʹ aniq maqniwq siqmi siqmi adawanh arwaңaancʹ sidya abiih nyah sit watorңadmh.q
/root/repos/dli_del/data/wav_split_gold/1294.wav	"Maqniwq ilye yada tănya maqniwq ŋuliq ŋuliq piyariănda yǎdad piyānda, "
/root/repos/dli_del/data/wav_split_gold/1127.wav	"mǣwna, ŋumgăna păŋgălmi syudbya inyaăna, "
/root/repos/dli_del/data/wav_split_gold/712.wav	Ŋămgǣmh tǣwran?
/root/repos/dli_del/data/wav_split_gold/1631.wav	Lǣqmoqrakond yuunda nyaad nyabakoda nyaqmada
/root/repos/dli_del/data/wav_split_gold/104.wav	"Tăd yedǣy yanh ŋamdwami ti,"
/root/repos/dli_del/data/wav_split_gold/686.wav	"săwăcyamda syera,"
/root/repos/dli_del/data/wav_split_gold/583.wav	ŋani taki nyaănda aqamh tyaăna mǣŋguwa».
/root/repos/dli_del/data/wav_split_gold/1696.wav	yeye.
/root/repos/dli_del/data/wav_split_gold/1655.wav	Wot takiye pribautki.
/root/repos/dli_del/data/wav_split_gold/1092.wav	tikanh tǣw-yaah. 
/root/repos/dli_del/data/wav_split_gold/575.wav	taminănda tiki ti tunda ǣwănh awănda».
/root/repos/dli_del/data/wav_split_gold/228.wav	myakna.
/root/repos/dli_del/data/wav_split_gold/204.wav	takad lǣyomdambido' 
/root/repos/dli_del/data/wav_split_gold/589.wav	"«Ŋanih takǣǣna onăŋguh,"
/root/repos/dli_del/data/wav_split_gold/1475.wav	"tiki yaadănda pǣrŋada, "
/root/repos/dli_del/data/wav_split_gold/553.wav	"  Ti wǣwa maqniwq taryemh,"
/root/repos/dli_del/data/wav_split_gold/282.wav	"ŋobh Way ŋǣsowi, "
/root/repos/dli_del/data/wav_split_gold/102.wav	Ŋǣya tikaăna ayoya. 
/root/repos/dli_del/data/wav_split_gold/1168.wav	yootah tad ŋǣdăwanda yaănanda tănya ŋădʹbăta syudǣǣyuta pomna pilibth pakăl-yh tiki yootada.
/root/repos/dli_del/data/wav_split_gold/1682.wav	 Warңǣ mandaңow mandaңoow. 
/root/repos/dli_del/data/wav_split_gold/1235.wav	ŋilimbinwa». 
/root/repos/dli_del/data/wav_split_gold/1352.wav	ayerta yadyemya.
/root/repos/dli_del/data/wav_split_gold/76.wav	Myaknaq ŋodh tǣwiwaq.
/root/repos/dli_del/data/wav_split_gold/1551.wav	"Ŋǣryoyq ŋǣwiq anih,"
/root/repos/dli_del/data/wav_split_gold/1567.wav	Nyabir ңacyekimh pǣmbiwa nyabir nyemh pǣmbiwa yedǣy mi nyeboy nyemh mǣwi nyenǣcʹh. 
/root/repos/dli_del/data/wav_split_gold/681.wav	Tah malăna nyudya ăbir ŋobh nyaătata tarănada niwŋaq adăananda adăananda.
/root/repos/dli_del/data/wav_split_gold/119.wav	Tăkad pǣwsyumya nyana ŋăniq tiq toq.
/root/repos/dli_del/data/wav_split_gold/671.wav	"tah malyaŋgana muŋgq tyesyetăna muŋgqyaq niqimh ŋaq tikitoh yesʹ silcʹ taraq,"
/root/repos/dli_del/data/wav_split_gold/481.wav	– ilyewandoh yambănh mălye tyabiibtawiq.
/root/repos/dli_del/data/wav_split_gold/799.wav	"yalǣmdata ŋulih ŋădimya syenyey asuy yalyadanda ăya anih, "
/root/repos/dli_del/data/wav_split_gold/1313.wav	«Mǣqmanda yalyand tănyabh maqniwq miŋgăr(muŋgăr) piyānda tyebăŋgu».
/root/repos/dli_del/data/wav_split_gold/343.wav	"«Tănyah, tănyah miŋadmh»"
/root/repos/dli_del/data/wav_split_gold/789.wav	tumda pyata.
/root/repos/dli_del/data/wav_split_gold/315.wav	Dadada. 
/root/repos/dli_del/data/wav_split_gold/151.wav	"Tărcya myestadăwa"" owa"" tanya' ŋǣsiwa""."
/root/repos/dli_del/data/wav_split_gold/520.wav	"Ŋaaq, maqniwq paryeŋodaăd săwawna ilye,"
/root/repos/dli_del/data/wav_split_gold/157.wav	"abǣyŋǣ ai"". "
/root/repos/dli_del/data/wav_split_gold/895.wav	"tyuku ancyerh ŋǣda maqniwq tǣ tuyesh sidya wǣh ilyewah yambanh maqniwq wadyoqmani yambanh manqniwq ŋobkărth tăryemh loomba nisih turh,"
/root/repos/dli_del/data/wav_split_gold/1239.wav	Muŋgo pyay ăbimh ŋopoyh mǣwanyoq».
/root/repos/dli_del/data/wav_split_gold/441.wav	Nyaanda taryemh man-in.
/root/repos/dli_del/data/wav_split_gold/710.wav	«akǣh ŋămgǣmh tǣwran?»
/root/repos/dli_del/data/wav_split_gold/48.wav	ŋǣni ŋodʹbyatoh wǣwaq ŋǣqnimh.
/root/repos/dli_del/data/wav_split_gold/446.wav	"«Ta, wadyesanh» "
/root/repos/dli_del/data/wav_split_gold/1324.wav	"ănoh tǣta,"
/root/repos/dli_del/data/wav_split_gold/394.wav	«Ŋawo pǣrŋan?»
/root/repos/dli_del/data/wav_split_gold/1534.wav	"«Ilyedmh, maqniwq mǣdăbh tǣwradmh». "
/root/repos/dli_del/data/wav_split_gold/192.wav	tadkad parada tara.
/root/repos/dli_del/data/wav_split_gold/1193.wav	Puucya mannaqmaq:
/root/repos/dli_del/data/wav_split_gold/227.wav	"sidnaq mǣn' tǣwra"" "
/root/repos/dli_del/data/wav_split_gold/945.wav	"ŋopoy mungănh mǣyda,"
/root/repos/dli_del/data/wav_split_gold/630.wav	"Maqniwq: «Yah obah ninya tarcya ilh yǎŋgoya, "
/root/repos/dli_del/data/wav_split_gold/350.wav	Tăryemh sirŋa nyerănda nyana yah oyh ninya ŋobh syurămbăda. 
/root/repos/dli_del/data/wav_split_gold/1366.wav	"abtqyaayuda piliq widărăŋaah,"
/root/repos/dli_del/data/wav_split_gold/524.wav	tad nyernyah solotǣriid nyenǣcʹh ilyebta ni taraq.
/root/repos/dli_del/data/wav_split_gold/1319.wav	 tănya ŋădʹbăta ăryoy myuykocyǎda tamӣnda malyē anih lukqyaq mǣnda paandh tidǣnda paăndh tah măntǣyq.
/root/repos/dli_del/data/wav_split_gold/1175.wav	syudbyaqyaqda soo myata nyoh sin tǣwotăŋo tădăw nyambor.
/root/repos/dli_del/data/wav_split_gold/1457.wav	"ŋămgǣh timiqmaq mălye,"
/root/repos/dli_del/data/wav_split_gold/1399.wav	maqniwq wari myakna maqniwq Wǣǣlya wǣsăko iriwaq tănyǎsyǎti.
/root/repos/dli_del/data/wav_split_gold/978.wav	"nyero yaah lăŋgana,"
/root/repos/dli_del/data/wav_split_gold/487.wav	"tăryemh man-in, păriq nyudoh yǎŋgoda. "
/root/repos/dli_del/data/wav_split_gold/113.wav	"Nu, mănyaq ăbărŋawaq tiki timh. "
/root/repos/dli_del/data/wav_split_gold/858.wav	«Ŋamgǣh yeqǣ̌mnya tyedah Muŋgoq pyay abidmh mănʹ tyedah ŋǣdăkǣdmh tyedanani?» 
/root/repos/dli_del/data/wav_split_gold/410.wav	ŋobtiki nyenǣy tuda ŋǣwi myata.
/root/repos/dli_del/data/wav_split_gold/338.wav	"Ti tikāna mărah ninya tikāna,"
/root/repos/dli_del/data/wav_split_gold/795.wav	"Myath tyuŋgu piina so,"
/root/repos/dli_del/data/wav_split_gold/1522.wav	"Sǣwni ŋădimyaq maqniwq syadnyah ŋamdiwah ăncyerq ŋa,"
/root/repos/dli_del/data/wav_split_gold/615.wav	taminănda tiki tunda ǣwanh aŋgu».
/root/repos/dli_del/data/wav_split_gold/1648.wav	 Tokcyaabi udq tawnyan sirah myaqni ңuq. 
/root/repos/dli_del/data/wav_split_gold/863.wav	Muŋgoq pyay abir ŋanih ŋǣwadi.
/root/repos/dli_del/data/wav_split_gold/904.wav	"«akǣh,"
/root/repos/dli_del/data/wav_split_gold/559.wav	Yalyah paryeŋoda maqniwq:
/root/repos/dli_del/data/wav_split_gold/1431.wav	«ănmi yarkqmadand maqniwq niwǣr ŋǣbqnand yarkq yendh siqmi anăŋgusʹ».
/root/repos/dli_del/data/wav_split_gold/941.wav	Muŋgoq pyay ăbi maqniwq:
/root/repos/dli_del/data/wav_split_gold/1363.wav	ŋămdanda pyelyamh.
/root/repos/dli_del/data/wav_split_gold/1605.wav	"	aaa."
/root/repos/dli_del/data/wav_split_gold/1730.wav	 obcokoq. 
/root/repos/dli_del/data/wav_split_gold/1382.wav	nyabi piyawnanda.
/root/repos/dli_del/data/wav_split_gold/1295.wav	maqniwq ŋămcaănda tyebbata ti ān».
/root/repos/dli_del/data/wav_split_gold/829.wav	ǣyyaq maqniwh puucya maqniwq tyedah nyuml ŋămgǣ ŋǣŋgu? 
/root/repos/dli_del/data/wav_split_gold/256.wav	"Tikid tyuquqnyana ǣqniqimh, "
/root/repos/dli_del/data/wav_split_gold/561.wav	"Ti, maqniwq: "
/root/repos/dli_del/data/wav_split_gold/469.wav	Yaah nyaqăwh nyana ānaq āyaq syerti' yǎŋgu maqniwq.
/root/repos/dli_del/data/wav_split_gold/1722.wav	 Tiki ǣǣh tu anyana aya? 
/root/repos/dli_del/data/wav_split_gold/69.wav	"Tikād (tikaăd) tikariina pǣwsyumnyana saltqninyu"" tikiq,"
/root/repos/dli_del/data/wav_split_gold/1038.wav	«Yedmih maqniwq mănʹ tyedăŋguw» 
/root/repos/dli_del/data/wav_split_gold/1693.wav	 Yaydamyeǣyq pukdamyeǣyq ңariq todoowq myerq myeryeqңayoow sibyalyaңgǣǣy marh oboow nyerdandoow lyeǣbtǣyeǣyq . 
/root/repos/dli_del/data/wav_split_gold/627.wav	tikaăna ti sӣŋgăw wuni tănyah.
/root/repos/dli_del/data/wav_split_gold/1240.wav	«Ti ŋămgǣ adkǣdiq ŋămgǣq? 
/root/repos/dli_del/data/wav_split_gold/60.wav	"ibya ānda?"" "
/root/repos/dli_del/data/wav_split_gold/707.wav	"Nidya ŋodh saălh, "
/root/repos/dli_del/data/wav_split_gold/107.wav	"Takădanda lusa ti ŋǣqniwaq,"
/root/repos/dli_del/data/wav_split_gold/541.wav	Ŋanih ŋamgǣh yeqǣ̄mnya tikaăd ŋanih tunh ărwanakǣǣh? 
/root/repos/dli_del/data/wav_split_gold/527.wav	 manʹ sudyewǣmi.
/root/repos/dli_del/data/wav_split_gold/1191.wav	Maqniwq yeǣranadaryewq laănăkurcʹ: 
/root/repos/dli_del/data/wav_split_gold/902.wav	Nidya ŋawh.
/root/repos/dli_del/data/wav_split_gold/1072.wav	Yeddih susa.
/root/repos/dli_del/data/wav_split_gold/285.wav	"tyedah mǣda, alʹmyerada tyuku ǣtah tyanyakuna ŋa "
/root/repos/dli_del/data/wav_split_gold/750.wav	"Maqniwq: «akǣh,"
/root/repos/dli_del/data/wav_split_gold/758.wav	"Tiki lăbtǣyh myunya silpăwiq muŋgonaq malh tikăana ŋaq,"
/root/repos/dli_del/data/wav_split_gold/1586.wav	Tyedah nyeңǣ nyeңǣ abta… 
/root/repos/dli_del/data/wav_split_gold/1498.wav	ărămh nisʹ mǣsǣ̄q Nyoyq măqrădyaŋgh nye nyumh tiki nyemh mǣq.
/root/repos/dli_del/data/wav_split_gold/1279.wav	"Maqniwq: «Mănʹ tyedah adā niw pirăth,"
/root/repos/dli_del/data/wav_split_gold/608.wav	mănʹ tăryemh syertawǣmi».
/root/repos/dli_del/data/wav_split_gold/856.wav	«Ti ŋǣqniwh ŋămgǣ sidyambonih ŋǣdăkǣnih?» 
/root/repos/dli_del/data/wav_split_gold/1749.wav	  A tiiyuda sidya. 
/root/repos/dli_del/data/wav_split_gold/1538.wav	"tiki Noy mărădyaŋgand nye,"
/root/repos/dli_del/data/wav_split_gold/1674.wav	anoto lǣǣna marabtyodadmh kaawǣy. 
/root/repos/dli_del/data/wav_split_gold/641.wav	unăndh solotǣy minărtaănda tǣwqniqimh.
/root/repos/dli_del/data/wav_split_gold/563.wav	maqniwq –
/root/repos/dli_del/data/wav_split_gold/1474.wav	" ti tiki sadă niklisyeq anih,"
/root/repos/dli_del/data/wav_split_gold/687.wav	tǣ tuyesăkomda nyǎqmaq ŋanih nyermya toǒnda ăya.
/root/repos/dli_del/data/wav_split_gold/1657.wav	 [Nyeracbortʃiwo]
/root/repos/dli_del/data/wav_split_gold/200.wav	"Tadkad ti ta yambuwa mǣ""ma""adana"" tyew' pir ŋǣbtaw' tiki, "
/root/repos/dli_del/data/wav_split_gold/20.wav	Tăd tikaăd natʃalʹniy klass' pud
/root/repos/dli_del/data/wav_split_gold/115.wav	"Ti myuyda pilikawanda ămgǣǣwaăna (ŋămgǣǣwaăna), ti, "
/root/repos/dli_del/data/wav_split_gold/1157.wav	ŋămgǣh pirkăna nisyarnyewononda yudǣqyaqawamda:
/root/repos/dli_del/data/wav_split_gold/479.wav	tikiq păriqyaq mănʹ tăryemh syertawini.
/root/repos/dli_del/data/wav_split_gold/358.wav	syudǣnda poŋgăna padda tiki piidămda soyaba lăbtorta ŋǣwi.
/root/repos/dli_del/data/wav_split_gold/1416.wav	"tiki ălcoqlǣmh tăd modā anih tyeǣ asăwanda ănh tiki mǣnh, "
/root/repos/dli_del/data/wav_split_gold/1125.wav	pidăr păŋgălmǣǣnand siqmi manondanăwa».
/root/repos/dli_del/data/wav_split_gold/1694.wav	Myatryewǣǣyq myatryewǣǣyq! 
/root/repos/dli_del/data/wav_split_gold/855.wav	adăkoyeda maqniwq:
/root/repos/dli_del/data/wav_split_gold/472.wav	"Taryemh nibqnandih ŋǣŋguq nyaandih man-in,"
/root/repos/dli_del/data/wav_split_gold/380.wav	«Niw ǣtăŋguq» 
/root/repos/dli_del/data/wav_split_gold/1316.wav	«Ŋămcaăndā tyebbăt aŋgăna niŋaq tikar ŋanih nisyerŋa».
/root/repos/dli_del/data/wav_split_gold/1427.wav	"ŋanih ŋărilibtyeda, "
/root/repos/dli_del/data/wav_split_gold/1163.wav	"nyambor tăsiy yanda ŋǣsomăna wǣrdawǣda, "
/root/repos/dli_del/data/wav_split_gold/1018.wav	"taykuy mi,"
/root/repos/dli_del/data/wav_split_gold/1297.wav	"siqiw ărămh aye anih,"
/root/repos/dli_del/data/wav_split_gold/881.wav	"Tiki puucyakoyer sawămda syera,"
/root/repos/dli_del/data/wav_split_gold/103.wav	Yedǣy yanh yamdǣynaq. 
/root/repos/dli_del/data/wav_split_gold/1591.wav	Tikadanda tandayarka wǣh ǣqmyaqarkaawaad ңanih syor ңod ңanih wuni arwaq yath. 
/root/repos/dli_del/data/wav_split_gold/1661.wav	 kogda wyesnoy prilyetayut w tundru.
/root/repos/dli_del/data/wav_split_gold/1499.wav	Tiki nyemh mǣqmaqadăndoh syanrindoh unh ilyenakiq anih?
/root/repos/dli_del/data/wav_split_gold/1658.wav	" Cnatʃit, ulyetaytye bistryeye, a to puli lyetyat wam nawstryetʃu."
/root/repos/dli_del/data/wav_split_gold/942.wav	"«Mănʹ tyedah ma siddaq mănǣkarcyadmh,"
/root/repos/dli_del/data/wav_split_gold/599.wav	"tiki yaănd aŋgun, "
/root/repos/dli_del/data/wav_split_gold/1432.wav	"Maqniwq: «Măncyaw ăyadmh,"
/root/repos/dli_del/data/wav_split_gold/72.wav	"Ti myadoqmăna yadǣrŋa, "
/root/repos/dli_del/data/wav_split_gold/1347.wav	Tuh yash putko. 
/root/repos/dli_del/data/wav_split_gold/677.wav	Ŋanir manda:
/root/repos/dli_del/data/wav_split_gold/166.wav	Ti wǣsăkoda ŋăni' taykuy Dudinka' 
/root/repos/dli_del/data/wav_split_gold/842.wav	"Taŋar, taŋok nyenǣciyeq yab."
/root/repos/dli_del/data/wav_split_gold/769.wav	"«Nyudya ăbi yekar ănyamna ayā,"
/root/repos/dli_del/data/wav_split_gold/975.wav	ŋămgǣdanda ăbărpăwnidā.
/root/repos/dli_del/data/wav_split_gold/248.wav	iiwaana tiki tiki mi abcya' lyekar 
/root/repos/dli_del/data/wav_split_gold/1666.wav	 Kak ʒye ǣto biloto?
/root/repos/dli_del/data/wav_split_gold/167.wav	wyetstanciya' nyaad ŋǣdasʹ. 
/root/repos/dli_del/data/wav_split_gold/101.wav	ŋobh tǣqyaq awi.
/root/repos/dli_del/data/wav_split_gold/1512.wav	"Tiki asăwar tiki nyemh pǣŋăda,"
/root/repos/dli_del/data/wav_split_gold/1451.wav	"Tădaw nyabănda, "
/root/repos/dli_del/data/wav_split_gold/1129.wav	Tăd maqniwq:
/root/repos/dli_del/data/wav_split_gold/1409.wav	"nyenǣciyeq poŋgăna maqniwq, "
/root/repos/dli_del/data/wav_split_gold/665.wav	salăba ŋulih ănimya. 
/root/repos/dli_del/data/wav_split_gold/314.wav	] Pyelyadkah ŋilʹnyakuna (N/PK)? 
/root/repos/dli_del/data/wav_split_gold/294.wav	"Tiq alʹmyerq taki manyaq, "
/root/repos/dli_del/data/wav_split_gold/1074.wav	adami ŋătyena».
/root/repos/dli_del/data/wav_split_gold/548.wav	ăbtyuma nyun da si nyancinh ŋămyanda malmh mǣŋguda ŋani punyakuh mǣŋguda tiki ŋacyeki a.
/root/repos/dli_del/data/wav_split_gold/752.wav	Maqniwq: 
/root/repos/dli_del/data/wav_split_gold/357.wav	"Yah ŋilh sǣywi ŋanih,"
/root/repos/dli_del/data/wav_split_gold/554.wav	"tăryemh mandānăwa,"
/root/repos/dli_del/data/wav_split_gold/295.wav	manyaq tiqnaq aqmaaw taki mi taki Noskoh nyaŋi ǣwarkaana ŋaq.
/root/repos/dli_del/data/wav_split_gold/564.wav	" mi, ŋani nyesʹ,"
/root/repos/dli_del/data/wav_split_gold/454.wav	"palciyodih, ŋanciyodih tikanh ămdă̌pidih,"
/root/repos/dli_del/data/wav_split_gold/781.wav	ŋămgǣ towna. 
/root/repos/dli_del/data/wav_split_gold/510.wav	maănda nyanā padda tănya. 
/root/repos/dli_del/data/wav_split_gold/636.wav	«Ŋuliq ŋoka ŋăcyekimh adadmh maqniwh nyusipoyh»
/root/repos/dli_del/data/wav_split_gold/5.wav	"maciŋamaciŋa (măncăraŋa măncăraŋa), "
/root/repos/dli_del/data/wav_split_gold/174.wav	"tiki ubt... samolyetăr amb""na"" tyuku posyelkăăd ubtiiri malye asawayu"" tʃasăna turŋa. "
/root/repos/dli_del/data/wav_split_gold/702.wav	Yedkocyǎmda tuyesăkomda sih nih ŋabtada. 
/root/repos/dli_del/data/wav_split_gold/797.wav	uh ŋulih pǣdǣy tiki puucyakoi.
/root/repos/dli_del/data/wav_split_gold/254.wav	tamalyaŋgi mancara nyaqmiqni 
/root/repos/dli_del/data/wav_split_gold/1282.wav	tyedah maqniwq adăŋguqniqwawh».
/root/repos/dli_del/data/wav_split_gold/1685.wav	nye nyu  onidoh  onidohnye nyu ooyaq ooyaq!
/root/repos/dli_del/data/wav_split_gold/1254.wav	"Wǣsako ŋodh pinh ăya, "
/root/repos/dli_del/data/wav_split_gold/419.wav	Siirtya maqniwq:
/root/repos/dli_del/data/wav_split_gold/1619.wav	Ңamgǣ syaqniq ңǣbtoh ңodh yewǣyh syancyoko ңawortaanda yurwi niwңaq wunida namdq abiiyut towamh. 
/root/repos/dli_del/data/wav_split_gold/1088.wav	pi ŋămgǣh nyerq niwh susaq.
/root/repos/dli_del/data/wav_split_gold/465.wav	tărcyaah.
/root/repos/dli_del/data/wav_split_gold/1113.wav	mănʹ taki mănʹ adami ŋatyena».
/root/repos/dli_del/data/wav_split_gold/1491.wav	ŋolyepyasawǣy tob-yewăraa maqniwq:
/root/repos/dli_del/data/wav_split_gold/85.wav	mǣnh ŋǣsiwaq ŋobh yanh.
/root/repos/dli_del/data/wav_split_gold/245.wav	yalando tyuku tincyaliiqnaq 
/root/repos/dli_del/data/wav_split_gold/1428.wav	tye asawanda ănh nih aqmiq. 
/root/repos/dli_del/data/wav_split_gold/456.wav	"Sidya asăwa, maqniwq, "
/root/repos/dli_del/data/wav_split_gold/42.wav	"Tamălyaŋgăna nyerdyenya ŋăcyeki (ŋătʃyeki),"
/root/repos/dli_del/data/wav_split_gold/1153.wav	"tănya tikaana miq, "
/root/repos/dli_del/data/wav_split_gold/852.wav	"«akǣh,"
/root/repos/dli_del/data/wav_split_gold/1217.wav	tyeda taykuy syeŋgănya asăwamh tyedah mănʹ adaŋguw.
/root/repos/dli_del/data/wav_split_gold/1507.wav	 Tăd tyuku ŋanih ŋămgǣ ŋǣsa? 
/root/repos/dli_del/data/wav_split_gold/1075.wav	"«Yebtako, nyoorcyan anʹq,"
/root/repos/dli_del/data/wav_split_gold/1705.wav	 Putkonda tyer mi ǣwakoriq syancyokoriq wandakoh myuh urǣyda. 
/root/repos/dli_del/data/wav_split_gold/1553.wav	"tăryemh incyelye anih nyeŋǣ, "
/root/repos/dli_del/data/wav_split_gold/45.wav	Lucah wadawna mancʹ sibirskiy yacwaăna aq.
/root/repos/dli_del/data/wav_split_gold/1482.wav	Noyǎnda myuh piidămda pǣbtada anih –
/root/repos/dli_del/data/wav_split_gold/462.wav	" Mănʹ tăryemh syertawǣǣyuni, maqniwq"
/root/repos/dli_del/data/wav_split_gold/1359.wav	"Maqniwq: «Ŋudar tikawna ŋǣdabtaărkărt,"
/root/repos/dli_del/data/wav_split_gold/155.wav	"Ti tăd ŋăniabid tyeǣ, "
/root/repos/dli_del/data/wav_split_gold/800.wav	maqniwq tyuku ăncyerh ŋa? 
/root/repos/dli_del/data/wav_split_gold/986.wav	ŋanih siqiw ăbărtamh adăŋgodakǣdmh arwobta ilyebciye adăŋgodăkǣdmh 
/root/repos/dli_del/data/wav_split_gold/324.wav	"Wǣy, ŋǣribta wuliq(ŋuliq),"
/root/repos/dli_del/data/wav_split_gold/130.wav	Tʃto tinaq tăryemh aq. 
/root/repos/dli_del/data/wav_split_gold/1104.wav	"Syariba pyaydyeh anih,"
/root/repos/dli_del/data/wav_split_gold/916.wav	Maqniwq: 
/root/repos/dli_del/data/wav_split_gold/407.wav	ŋani ŋobh myadh nimnya ŋadimya.
/root/repos/dli_del/data/wav_split_gold/1304.wav	"orkih, orkih nyayuh  ŋaq, "
/root/repos/dli_del/data/wav_split_gold/339.wav	tikāna pindinaq. 
/root/repos/dli_del/data/wav_split_gold/131.wav	"Nu, poka taki raciyamh osayawan',"
/root/repos/dli_del/data/wav_split_gold/272.wav	"Ŋawnandoh nyenǣcyaq tiki, "
/root/repos/dli_del/data/wav_split_gold/492.wav	siqiw wǣbărkaqyaq ŋuliq maqniwq tirăwiq maqniwq  pidăndoh măsidoh ŋuliq maqniwq ŋuliq lyaddowiq.
/root/repos/dli_del/data/wav_split_gold/1548.wav	nyuda wunisa tănyaq.
/root/repos/dli_del/data/wav_split_gold/264.wav	[...]
/root/repos/dli_del/data/wav_split_gold/1275.wav	"«Tyedah, "
/root/repos/dli_del/data/wav_split_gold/1124.wav	"«Manoyh – manoyh, "
/root/repos/dli_del/data/wav_split_gold/1101.wav	"Sidya syudbyar ŋuwo niŋga syaarih piruwna ŋuwo niŋgnakǣǣh,"
/root/repos/dli_del/data/wav_split_gold/950.wav	"ăbărpa pyayda anih,"
/root/repos/dli_del/data/wav_split_gold/1593.wav	 nyaarq adǣtowңǣyh yaah madanowңǣy ңanoyeyңǣsyeyңǣy artoh tyaladowңǣyh ңawkah sǣqryeko.
/root/repos/dli_del/data/wav_split_gold/1147.wav	"ŋilika ŋǣsyanda niwŋaq,"
/root/repos/dli_del/data/wav_split_gold/75.wav	ŋămgǣǣw myakaqnaq.
/root/repos/dli_del/data/wav_split_gold/628.wav	Nyabi nyeh myath niwh myattyuh. 
/root/repos/dli_del/data/wav_split_gold/841.wav	"Ŋămgǣ ŋǣŋgu, ŋămgǣ aŋgu?"
/root/repos/dli_del/data/wav_split_gold/90.wav	"Tiki paddyenaq tiq tiki syan yaŋorǣyh tăd tăryemh anqŋaq, ti,"
/root/repos/dli_del/data/wav_split_gold/1212.wav	"wǣsăko  săwuma anih, "
/root/repos/dli_del/data/wav_split_gold/1343.wav	adq ŋǣdakiq.
/root/repos/dli_del/data/wav_split_gold/125.wav	"ŋobh ti wǣnyekoh syertoh nyu"" ŋaq, nid tanyana ŋōrmiq."
/root/repos/dli_del/data/wav_split_gold/253.wav	Tyedah mi taki anyaŋǣriq tyuku mǣriq ti ni ayuq 
/root/repos/dli_del/data/wav_split_gold/1026.wav	"Yed pina anih,"
/root/repos/dli_del/data/wav_split_gold/24.wav	Ti tiki mǣǣna taminni Karaulăna yolʹcyeyawh.
/root/repos/dli_del/data/wav_split_gold/817.wav	Tiki ŋăcyekǣr ŋobh ŋamgǣ yaqăwkabtăda ŋăcyeki ŋǣwi. 
/root/repos/dli_del/data/wav_split_gold/1486.wav	laănăko ǣwnyana ăya. 
/root/repos/dli_del/data/wav_split_gold/162.wav	"Tădkad tiki mi"" oy' ni' tikit "
/root/repos/dli_del/data/wav_split_gold/1049.wav	Muŋgoh pyay ăbi maqniwq:  
/root/repos/dli_del/data/wav_split_gold/565.wav	pida mǣmda mǣmbi». 
/root/repos/dli_del/data/wav_split_gold/1311.wav	Ti tikawna maqniwq mǣnd yambănh ŋilʹnyah yanh mǣnh yeqŋaq lăngrinh sirta maqniwq».
/root/repos/dli_del/data/wav_split_gold/894.wav	"«akǣh, "
/root/repos/dli_del/data/wav_split_gold/573.wav	tăryemh ti man-in».
/root/repos/dli_del/data/wav_split_gold/1053.wav	Muŋgoh pyay ăbi yath ti ŋămgǣh pirkăna irsuh ŋăworŋaah Syudbya wǣsakomh măniyedā tarsih tyuki widărăŋō.
/root/repos/dli_del/data/wav_split_gold/39.wav	"Ta, ti tăryemh măncăraqmaădănaq syanaw po ǣnyaki."
/root/repos/dli_del/data/wav_split_gold/182.wav	"punyaŋi ti""na"" a""ma' "
/root/repos/dli_del/data/wav_split_gold/1098.wav	ŋumdămih niŋgăanih ti syanakodanih».
/root/repos/dli_del/data/wav_split_gold/1578.wav	" Ilh mi woma aniq, "
/root/repos/dli_del/data/wav_split_gold/138.wav	tika punyah sălmidh.  
/root/repos/dli_del/data/wav_split_gold/1391.wav	unyana numh yalǣmdaki.
/root/repos/dli_del/data/wav_split_gold/698.wav	«Ilyewah yambănh   maqniwq –
/root/repos/dli_del/data/wav_split_gold/1463.wav	"ărmh anā, "
/root/repos/dli_del/data/wav_split_gold/1524.wav	Myadikocyah myunya mǣwǣdamnyoq maqniwq   
/root/repos/dli_del/data/wav_split_gold/1703.wav	 ǣwakoriq syancyokoriq! 
/root/repos/dli_del/data/wav_split_gold/906.wav	"tyuku mih myuh syaartănh,"
/root/repos/dli_del/data/wav_split_gold/266.wav	"Iiwaana tyedah tikih yeqǣmnya tyedah, "
/root/repos/dli_del/data/wav_split_gold/655.wav	Ti maqniwq: «Tad nyernyah yesya arwmh wadăbăda yǎŋgoya.
/root/repos/dli_del/data/wav_split_gold/820.wav	Sirăawh tiki ŋăcyekǣr laănako mǣqladow tădaw.
/root/repos/dli_del/data/wav_split_gold/678.wav	«Itwaq osqmah ŋarka ăbē». 
/root/repos/dli_del/data/wav_split_gold/813.wav	Ŋarmā anih ŋulih anyaărt nidya puucya ŋǣdărambsyatuh.
/root/repos/dli_del/data/wav_split_gold/955.wav	Maqniwq:
/root/repos/dli_del/data/wav_split_gold/1485.wav	"Miniko ayeda,"
/root/repos/dli_del/data/wav_split_gold/965.wav	Maqniwq: 
/root/repos/dli_del/data/wav_split_gold/453.wav	"Maqniwq,"
/root/repos/dli_del/data/wav_split_gold/1510.wav	tyukoow ŋămgǣh nyenǣcyah aqmaq ŋǣwinyoh.
/root/repos/dli_del/data/wav_split_gold/1329.wav	Siqiw yurh uryoda asryoona ilye.
/root/repos/dli_del/data/wav_split_gold/1354.wav	syaqniq ŋǣdakǣ̄q.
/root/repos/dli_del/data/wav_split_gold/1090.wav	" syudbyako asryeqǣh yernya ŋobh syudbyako yesya sălqyaq nyenǣcyah lih yamb,"
/root/repos/dli_del/data/wav_split_gold/370.wav	"ayeradh yah paryǎh mǣnh tǣwăăbăt, "
/root/repos/dli_del/data/wav_split_gold/389.wav	Ŋobh nye.
/root/repos/dli_del/data/wav_split_gold/819.wav	Ŋămyǎnda talbǣyăna nidawh ŋăwlambyuh tiki yambănh.
/root/repos/dli_del/data/wav_split_gold/7.wav	ŋokawna mac-i macampi (ŋokawna mancai mancambi). 
/root/repos/dli_del/data/wav_split_gold/1050.wav	"«Mi, ŋōrta nyenǣcyaŋgaw ănyarina ŋamdyoyawa, "
/root/repos/dli_del/data/wav_split_gold/276.wav	"Tamalyaŋgi nyenǣcyar wuni sirq, "
/root/repos/dli_del/data/wav_split_gold/261.wav	 yath mancyaw ti nyani tawǣdo yaŋgusʹ. 
/root/repos/dli_del/data/wav_split_gold/1112.wav	"«Ŋobh tiki păŋgăltăwa ani,"
/root/repos/dli_del/data/wav_split_gold/844.wav	onaŋguh.
/root/repos/dli_del/data/wav_split_gold/421.wav	ayeradh paryeŋodanh siqmi ŋǣdabta».
/root/repos/dli_del/data/wav_split_gold/1647.wav	 Lǣqmoqrakow tokcid taq! 
/root/repos/dli_del/data/wav_split_gold/84.wav	Ŋa nyerdyenyaănanda
/root/repos/dli_del/data/wav_split_gold/1267.wav	" «Wǣy, mi, tikini tyuku ŋǣdaki,"
/root/repos/dli_del/data/wav_split_gold/451.wav	"maqniwq, ŋamdiih."
/root/repos/dli_del/data/wav_split_gold/1560.wav	Tadawa tiki asawaah tad tikan nultadima myata anyerq ǣwanh. 
/root/repos/dli_del/data/wav_split_gold/1330.wav	"Nyanda, "
/root/repos/dli_del/data/wav_split_gold/1218.wav	"Manʹ tyedah mi myaqni măkodah sinh,"
/root/repos/dli_del/data/wav_split_gold/920.wav	siqiw ăbi tănyasyē anih maqniwq ti».
/root/repos/dli_del/data/wav_split_gold/96.wav	tămna ŋobkăd pyeryeq. 
/root/repos/dli_del/data/wav_split_gold/1227.wav	"Ŋa pida nyeda,"
/root/repos/dli_del/data/wav_split_gold/215.wav	"tyew' ŋar mǣ""ya"" "
/root/repos/dli_del/data/wav_split_gold/309.wav	ŋodʹbyatoh tamna ŋobkad nih pyeryeq tiki liq. 
/root/repos/dli_del/data/wav_split_gold/128.wav	Ti tădtikaăd ătʃyerq(ăncyerq) mǣŋgunaq. 
/root/repos/dli_del/data/wav_split_gold/516.wav	"Solotǣri talyebăda nyenǣcʹh maqniwq ŋamgǣ mutraana ma yah tyerq solotǣy maqniwq talyebădakida maqniwq yekar ancyerq ŋǣda nyenǣcʹh,"
/root/repos/dli_del/data/wav_split_gold/1243.wav	Ti tiki yaăna tănya ayoya. 
/root/repos/dli_del/data/wav_split_gold/522.wav	Tiki solotǣy maqniwq ănyad ombida?
/root/repos/dli_del/data/wav_split_gold/946.wav	ŋa awotoh siqimnya.
/root/repos/dli_del/data/wav_split_gold/543.wav	maqniwq.
/root/repos/dli_del/data/wav_split_gold/609.wav	«usuwǣy – maqniwq –
/root/repos/dli_del/data/wav_split_gold/1530.wav	Tănyah tǣwqmaawaădănda Noy mărădyaŋgawar myadh ancowna inrada myata anyerh ancowna.
/root/repos/dli_del/data/wav_split_gold/126.wav	Tăd tănyad toq tad tă tăryem ti posawidh.
/root/repos/dli_del/data/wav_split_gold/610.wav	"nyanda asăwămh maqniwq,"
/root/repos/dli_del/data/wav_split_gold/1754.wav	 Ңumb-ya. 
/root/repos/dli_del/data/wav_split_gold/329.wav	nyaŋǣdya tah yambănh tyukona mǣwaq.˜
/root/repos/dli_del/data/wav_split_gold/1751.wav	 aaa.
/root/repos/dli_del/data/wav_split_gold/977.wav	"taykuna ǣbidya yamih tăniwa,"
/root/repos/dli_del/data/wav_split_gold/533.wav	Maqniwq ti tǣtaănd toqmaadand mandanăwa Siirtya. 
/root/repos/dli_del/data/wav_split_gold/987.wav	syudbyamh andadmh?»
/root/repos/dli_del/data/wav_split_gold/530.wav	talyey ŋǣŋgobqnanda ti tiki yah ŋilh sǣyǎŋgu. 
/root/repos/dli_del/data/wav_split_gold/402.wav	Maqniwq:
/root/repos/dli_del/data/wav_split_gold/1495.wav	«Ŋǣwi». 
/root/repos/dli_del/data/wav_split_gold/371.wav	"yalyah paryeŋodan_(paraŋodanh),"
/root/repos/dli_del/data/wav_split_gold/1287.wav	"Lămbid syerosaq aniq, "
/root/repos/dli_del/data/wav_split_gold/1406.wav	abqnanyē pilibth ŋămgǣdănd mǣŋgurăwa».
/root/repos/dli_del/data/wav_split_gold/1546.wav	asăwa ŋăcyeki.
/root/repos/dli_del/data/wav_split_gold/1671.wav	 Kaawǣy KaawKaaw. 
/root/repos/dli_del/data/wav_split_gold/1469.wav	" Sirah yambana tăryemh niwh yadah syowna antaq minq wuniq tănyaq, "
/root/repos/dli_del/data/wav_split_gold/93.wav	tyukuq ămgǣq (ŋămgǣq)? 
/root/repos/dli_del/data/wav_split_gold/341.wav	"«Siirtya, ănyah ăyan?»"
/root/repos/dli_del/data/wav_split_gold/788.wav	"Puucya yurkiq,"
/root/repos/dli_del/data/wav_split_gold/779.wav	"Nyakuh syenyey nyeboyh yolʹcyǎŋǣ ăya, "
/root/repos/dli_del/data/wav_split_gold/1421.wav	"orkit yay ŋōroqmaqdăni, "
/root/repos/dli_del/data/wav_split_gold/925.wav	Maqniwq:
/root/repos/dli_del/data/wav_split_gold/18.wav	natʃalʹniy klass' yolʹcyandh (yolʹtʃyand') padnadmh.
/root/repos/dli_del/data/wav_split_gold/1067.wav	"«Yāŋgō, tǣri yah taborokoqmana». "
/root/repos/dli_del/data/wav_split_gold/870.wav	"«Mi, akǣh,"
/root/repos/dli_del/data/wav_split_gold/1256.wav	"Tiki nyer ŋanih yurkiq, "
/root/repos/dli_del/data/wav_split_gold/1233.wav	"«Ti wǣnyekow maqniwq tăryemh sit mǣŋgosadmh măqniwq, "
/root/repos/dli_del/data/wav_split_gold/1342.wav	"tăŋih ŋǣdakiq,"
/root/repos/dli_del/data/wav_split_gold/73.wav	tamălyaŋgăna ŋawodăna acyanawah syeŋgq